Time,HoTe,AwTe,FTHG,FTAG,FTR,HTHG,HTAG,HTR,Ref,HS,AS,HST,AST,HF,AF,HC,AC,HY,AY,HR,AR,HBP,ABP,HTTG,FTTG,TS,TST,TC,TF,TY,TR
15:00,Barnsley,Port Vale,7,0,H,2,0,H,D Rock,12,13,8,4,15,14,3,6,6,2,0,0,60,20,2,7,25,12,9,29,8,0
15:00,Blackpool,Burton,2,0,H,2,0,H,S Stockbridge,15,9,4,3,10,12,7,4,4,1,0,0,40,10,2,2,24,7,11,22,5,0
15:00,Bolton,Lincoln,3,0,H,1,0,H,W Finnie,16,6,4,0,19,16,10,1,3,3,0,0,30,30,1,3,22,4,11,35,6,0
15:00,Cambridge,Oxford,2,0,H,2,0,H,S Gill,10,10,6,3,9,10,2,10,4,1,0,0,40,10,2,2,20,9,12,19,5,0
15:00,Carlisle,Fleetwood Town,1,1,D,1,1,D,P Wright,15,13,6,5,8,18,5,2,2,3,0,0,20,30,2,2,28,11,7,26,5,0
15:00,Charlton,Leyton Orient,1,0,H,1,0,H,A Kitchen,13,8,5,3,9,14,2,3,3,2,0,0,30,20,1,1,21,8,5,23,5,0
15:00,Derby,Wigan,1,2,A,0,1,A,S Oldham,21,7,5,3,11,6,11,4,2,2,0,0,20,20,1,3,28,8,15,17,4,0
15:00,Northampton,Stevenage,0,1,A,0,0,D,L Smith,8,14,0,5,13,12,7,4,2,3,0,0,20,30,0,1,22,5,11,25,5,0
15:00,Portsmouth,Bristol Rvs,1,1,D,0,1,A,S Allison,21,10,5,6,14,13,11,3,4,3,0,0,40,30,1,2,31,11,14,27,7,0
15:00,Reading,Peterboro,0,1,A,0,1,A,S Mather,15,13,4,6,12,9,6,6,6,4,0,0,60,40,1,1,28,10,12,21,10,0
15:00,Shrewsbury,Cheltenham,1,0,H,0,0,D,C Pollard,12,16,3,4,10,7,5,4,3,2,0,0,30,20,0,1,28,7,9,17,5,0
15:00,Wycombe,Exeter,0,3,A,0,2,A,C Breakspear,10,11,1,7,11,12,4,5,2,2,0,0,20,20,2,3,21,8,9,23,4,0
15:00,Bristol Rvs,Barnsley,1,1,D,0,1,A,C Brook,15,9,4,3,13,10,7,2,0,3,0,0,0,30,1,2,24,7,9,23,3,0
15:00,Burton,Derby,0,3,A,0,1,A,J Bell,14,8,2,5,12,7,6,2,1,3,0,0,10,30,1,3,22,7,8,19,4,0
15:00,Cheltenham,Bolton,0,3,A,0,3,A,D Rock,5,16,2,7,7,9,3,9,2,1,0,0,20,10,3,3,21,9,12,16,3,0
15:00,Exeter,Blackpool,0,0,D,0,0,D,S Purkiss,11,4,1,3,6,7,6,7,2,1,0,0,20,10,0,0,15,4,13,13,3,0
15:00,Fleetwood Town,Cambridge,0,2,A,0,1,A,S Stockbridge,13,16,2,7,16,14,9,6,3,3,0,0,30,30,1,2,29,9,15,30,6,0
15:00,Leyton Orient,Portsmouth,0,4,A,0,2,A,O Yates,11,10,3,4,10,8,3,3,2,2,0,0,20,20,2,4,21,7,6,18,4,0
15:00,Lincoln,Wycombe,3,0,H,0,0,D,A Herczeg,14,7,8,4,11,12,3,6,2,2,0,0,20,20,0,3,21,12,9,23,4,0
15:00,Oxford,Carlisle,1,0,H,0,0,D,J Simpson,14,8,3,0,9,17,5,4,0,4,0,0,0,40,0,1,22,3,9,26,4,0
15:00,Peterboro,Charlton,1,0,H,1,0,H,L Swabey,14,12,3,2,15,12,7,5,5,5,0,0,50,50,1,1,26,5,12,27,10,0
15:00,Port Vale,Reading,1,0,H,0,0,D,P Wright,17,9,3,1,7,11,5,2,0,2,0,0,0,20,0,1,26,4,7,18,2,0
15:00,Stevenage,Shrewsbury,2,0,H,0,0,D,C Hicks,14,2,6,1,7,12,13,3,0,3,0,0,0,30,0,2,16,7,16,19,3,0
15:00,Wigan,Northampton,2,1,H,0,1,A,R Joyce,24,17,5,3,10,14,8,5,4,4,0,0,40,40,1,3,41,8,13,24,8,0
19:45,Barnsley,Peterboro,1,3,A,0,0,D,A Backhouse,13,18,7,9,7,7,10,5,0,1,0,0,0,10,0,4,31,16,15,14,1,0
19:45,Blackpool,Port Vale,0,0,D,0,0,D,R Joyce,14,8,4,1,5,9,4,2,1,1,0,0,10,10,0,0,22,5,6,14,2,0
19:45,Bolton,Fleetwood Town,3,1,H,3,0,H,T Nield,8,10,5,7,11,12,5,12,2,4,1,0,45,40,3,4,18,12,17,23,6,1
19:45,Cambridge,Stevenage,1,2,A,0,1,A,W Finnie,11,11,3,6,11,17,6,3,0,3,0,0,0,30,1,3,22,9,9,28,3,0
19:45,Carlisle,Wigan,1,1,D,0,1,A,M Edwards,11,14,2,4,15,6,3,5,4,2,0,0,40,20,1,2,25,6,8,21,6,0
19:45,Charlton,Bristol Rvs,1,2,A,0,0,D,C Breakspear,18,14,5,7,12,6,7,5,1,2,0,0,10,20,0,3,32,12,12,18,3,0
19:45,Derby,Oxford,1,2,A,0,1,A,B Toner,11,14,4,4,17,13,15,4,5,2,0,0,50,20,1,3,25,8,19,30,7,0
19:45,Northampton,Lincoln,2,2,D,0,1,A,O Yates,19,6,9,3,9,7,3,1,1,0,0,0,10,0,1,4,25,12,4,16,1,0
19:45,Shrewsbury,Burton,2,1,H,2,0,H,S Oldham,9,12,3,4,7,14,4,3,1,4,0,0,10,40,2,3,21,7,7,21,5,0
19:45,Wycombe,Leyton Orient,3,2,H,1,1,D,T Parsons,15,15,6,6,4,8,3,7,1,3,0,1,10,55,2,5,30,12,10,12,4,1
20:00,Portsmouth,Exeter,1,0,H,0,0,D,T Reeves,13,9,7,5,14,11,8,6,5,1,0,0,50,10,0,1,22,12,14,25,6,0
20:00,Reading,Cheltenham,1,0,H,1,0,H,B Speedie,11,10,4,3,11,7,7,7,2,2,0,0,20,20,1,1,21,7,14,18,4,0
12:30,Bolton,Wigan,0,4,A,0,3,A,T Reeves,20,11,4,5,18,11,4,2,2,3,0,0,20,30,3,4,31,9,6,29,5,0
15:00,Barnsley,Oxford,1,3,A,0,1,A,M Coy,14,14,6,8,10,5,9,8,3,2,0,0,30,20,1,4,28,14,17,15,5,0
15:00,Blackpool,Leyton Orient,0,0,D,0,0,D,M Edwards,15,9,5,2,8,8,8,1,0,4,0,0,0,40,0,0,24,7,9,16,4,0
15:00,Cambridge,Bristol Rvs,2,0,H,0,0,D,J Busby,12,7,4,5,16,10,6,4,1,3,0,0,10,30,0,2,19,9,10,26,4,0
15:00,Carlisle,Exeter,0,2,A,0,0,D,A Herczeg,13,11,6,3,5,10,11,3,0,1,0,0,0,10,0,2,24,9,14,15,1,0
15:00,Charlton,Port Vale,2,3,A,1,0,H,S Gill,17,15,7,5,15,13,9,4,4,3,0,0,40,30,1,5,32,12,13,28,7,0
15:00,Derby,Fleetwood Town,1,0,H,1,0,H,L Swabey,14,8,3,2,11,13,7,9,3,3,0,0,30,30,1,1,22,5,16,24,6,0
15:00,Northampton,Peterboro,1,0,H,0,0,D,M Woods,9,17,2,1,7,9,4,5,1,2,0,0,10,20,0,1,26,3,9,16,3,0
15:00,Portsmouth,Cheltenham,0,0,D,0,0,D,B Toner,15,12,5,1,9,14,5,5,0,3,0,0,0,30,0,0,27,6,10,23,3,0
15:00,Reading,Stevenage,2,0,H,1,0,H,A Backhouse,20,6,7,4,12,8,7,0,0,3,0,1,0,55,1,2,26,11,7,20,3,1
15:00,Shrewsbury,Lincoln,0,1,A,0,0,D,R Joyce,11,7,2,3,9,13,6,1,2,4,0,0,20,40,0,1,18,5,7,22,6,0
15:00,Wycombe,Burton,0,0,D,0,0,D,T Kirk,14,7,8,3,10,10,6,2,2,2,0,0,20,20,0,0,21,11,8,20,4,0
15:00,Bristol Rvs,Wycombe,1,2,A,0,1,A,L Swabey,12,12,1,5,12,6,7,3,3,0,0,0,30,0,1,3,24,6,10,18,3,0
15:00,Burton,Bolton,1,1,D,0,0,D,C Brook,13,17,3,6,13,12,4,8,6,2,0,0,60,20,0,2,30,9,12,25,8,0
15:00,Cheltenham,Northampton,0,1,A,0,0,D,T Nield,8,15,2,2,8,8,1,8,1,2,0,0,10,20,0,1,23,4,9,16,3,0
15:00,Exeter,Reading,2,1,H,1,1,D,W Finnie,20,12,4,3,10,9,7,7,3,4,0,0,30,40,2,3,32,7,14,19,7,0
15:00,Fleetwood Town,Shrewsbury,0,1,A,0,1,A,B Speedie,9,5,1,2,14,12,9,1,1,3,2,0,60,30,1,1,14,3,10,26,4,2
15:00,Leyton Orient,Cambridge,2,0,H,1,0,H,S Martin,16,10,3,3,15,14,5,7,4,4,0,0,40,40,1,2,26,6,12,29,8,0
15:00,Lincoln,Blackpool,3,0,H,2,0,H,M Coy,11,14,5,3,13,13,1,2,1,0,0,1,10,25,2,3,25,8,3,26,1,1
15:00,Oxford,Charlton,2,1,H,1,0,H,A Herczeg,16,9,5,3,11,16,7,1,3,6,0,0,30,60,1,3,25,8,8,27,9,0
15:00,Peterboro,Derby,2,4,A,1,4,A,L Smith,16,14,6,5,6,12,8,9,2,1,0,0,20,10,5,6,30,11,17,18,3,0
15:00,Port Vale,Carlisle,1,0,H,0,0,D,T Reeves,17,10,5,2,6,9,8,8,0,0,0,0,0,0,0,1,27,7,16,15,0,0
15:00,Stevenage,Portsmouth,0,0,D,0,0,D,S Mather,12,13,3,2,12,13,4,7,4,3,1,1,65,55,0,0,25,5,11,25,7,2
15:00,Wigan,Barnsley,0,2,A,0,1,A,S Stockbridge,9,19,1,8,7,14,4,5,1,3,1,0,35,30,1,2,28,9,9,21,4,1
15:00,Blackpool,Wigan,2,1,H,1,0,H,A Backhouse,14,6,7,3,14,7,4,3,3,3,0,0,30,30,1,3,20,10,7,21,6,0
15:00,Bolton,Derby,2,1,H,1,1,D,C Breakspear,17,10,4,1,11,9,7,6,3,2,0,1,30,45,2,3,27,5,13,20,5,1
15:00,Bristol Rvs,Lincoln,1,1,D,0,0,D,L Smith,11,12,3,5,9,8,7,5,2,3,0,0,20,30,0,2,23,8,12,17,5,0
15:00,Burton,Exeter,0,1,A,0,0,D,G Eltringham,9,16,5,4,14,8,3,5,2,1,1,0,45,10,0,1,25,9,8,22,3,1
15:00,Carlisle,Shrewsbury,2,0,H,0,0,D,B Toner,11,9,2,2,11,8,8,6,2,4,0,0,20,40,0,2,20,4,14,19,6,0
15:00,Charlton,Fleetwood Town,2,1,H,1,1,D,C Brook,17,11,4,3,12,12,13,4,4,3,0,0,40,30,2,3,28,7,17,24,7,0
15:00,Cheltenham,Barnsley,0,2,A,0,0,D,S Gill,17,19,5,5,9,11,7,4,3,3,0,0,30,30,0,2,36,10,11,20,6,0
15:00,Leyton Orient,Stevenage,0,3,A,0,2,A,K Stroud,8,10,2,4,13,9,9,6,2,1,0,0,20,10,2,3,18,6,15,22,3,0
15:00,Northampton,Wycombe,0,1,A,0,1,A,T Reeves,20,7,6,1,12,9,5,3,0,2,0,0,0,20,1,1,27,7,8,21,2,0
15:00,Oxford,Port Vale,1,2,A,0,0,D,S Purkiss,13,8,6,5,8,14,5,3,1,2,2,0,60,20,0,3,21,11,8,22,3,2
15:00,Portsmouth,Peterboro,3,1,H,2,1,H,D Rock,18,16,7,4,10,12,10,9,1,3,1,0,35,30,3,4,34,11,19,22,4,1
20:00,Cambridge,Reading,1,0,H,0,0,D,D Drysdale,17,13,3,4,8,15,9,5,1,4,0,0,10,40,0,1,30,7,14,23,5,0
15:00,Exeter,Leyton Orient,1,2,A,0,0,D,B Toner,5,19,2,7,12,10,4,10,3,3,0,0,30,30,0,3,24,9,14,22,6,0
15:00,Stevenage,Carlisle,2,2,D,1,1,D,D Drysdale,16,4,8,2,13,10,11,2,2,2,0,0,20,20,2,4,20,10,13,23,4,0
15:00,Barnsley,Burton,2,0,H,1,0,H,M Edwards,8,8,3,1,5,10,0,2,0,0,0,0,0,0,1,2,16,4,2,15,0,0
15:00,Derby,Portsmouth,1,1,D,0,0,D,R Welch,8,14,1,5,16,9,4,8,2,3,0,0,20,30,0,2,22,6,12,25,5,0
15:00,Exeter,Cheltenham,1,0,H,0,0,D,M Woods,20,9,7,2,11,9,8,2,3,2,0,0,30,20,0,1,29,9,10,20,5,0
15:00,Fleetwood Town,Oxford,0,3,A,0,2,A,W Finnie,11,10,0,5,12,7,9,4,2,0,0,0,20,0,2,3,21,5,13,19,2,0
15:00,Lincoln,Carlisle,1,1,D,0,1,A,T Nield,12,14,4,6,9,13,2,1,1,5,0,0,10,50,1,2,26,10,3,22,6,0
15:00,Peterboro,Leyton Orient,1,1,D,1,1,D,S Tallis,7,6,5,2,8,17,6,3,2,3,0,0,20,30,2,2,13,7,9,25,5,0
15:00,Port Vale,Northampton,1,0,H,0,0,D,S Oldham,13,5,4,1,7,6,5,3,1,0,0,0,10,0,0,1,18,5,8,13,1,0
15:00,Reading,Bolton,2,1,H,0,1,A,L Swabey,18,10,7,5,17,15,6,4,3,4,0,1,30,65,1,3,28,12,10,32,7,1
15:00,Shrewsbury,Bristol Rvs,0,2,A,0,0,D,T Reeves,12,9,4,4,14,10,5,6,2,3,0,0,20,30,0,2,21,8,11,24,5,0
15:00,Stevenage,Charlton,1,1,D,1,0,H,P Wright,9,12,3,1,10,16,5,4,3,3,0,0,30,30,1,2,21,4,9,26,6,0
15:00,Wigan,Cambridge,2,1,H,0,0,D,A Herczeg,6,18,3,3,13,10,3,2,2,0,0,0,20,0,0,3,24,6,5,23,2,0
15:00,Wycombe,Blackpool,2,0,H,1,0,H,N Hair,10,11,4,2,14,11,0,5,3,1,0,0,30,10,1,2,21,6,5,25,4,0
19:45,Barnsley,Portsmouth,2,3,A,0,3,A,L Smith,15,16,3,6,13,8,3,5,0,1,0,0,0,10,3,5,31,9,8,21,1,0
19:45,Peterboro,Cheltenham,3,0,H,0,0,D,S Oldham,24,2,5,0,7,6,15,1,0,0,0,2,0,50,0,3,26,5,16,13,0,2
19:45,Port Vale,Burton,2,3,A,1,1,D,B Toner,19,8,9,3,11,12,7,1,2,3,0,0,20,30,2,5,27,12,8,23,5,0
15:00,Blackpool,Reading,4,1,H,3,0,H,T Reeves,17,5,6,4,7,12,10,3,0,1,0,0,0,10,3,5,22,10,13,19,1,0
15:00,Bolton,Peterboro,1,1,D,1,1,D,R Joyce,7,25,3,6,11,14,8,10,4,2,1,0,65,20,2,2,32,9,18,25,6,1
15:00,Bristol Rvs,Wigan,4,1,H,2,1,H,G Eltringham,15,9,6,3,12,15,3,5,3,2,0,0,30,20,3,5,24,9,8,27,5,0
15:00,Burton,Fleetwood Town,1,1,D,1,1,D,O Yates,13,13,2,4,9,9,4,5,2,0,0,0,20,0,2,2,26,6,9,18,2,0
15:00,Cambridge,Port Vale,1,1,D,0,1,A,C Pollard,12,8,5,2,9,14,7,7,0,4,0,0,0,40,1,2,20,7,14,23,4,0
15:00,Carlisle,Derby,0,2,A,0,1,A,M Coy,9,9,4,2,8,13,8,2,1,1,0,0,10,10,1,2,18,6,10,21,2,0
15:00,Charlton,Wycombe,3,1,H,1,0,H,B Toner,9,12,6,1,15,10,7,6,3,2,0,0,30,20,1,4,21,7,13,25,5,0
15:00,Cheltenham,Stevenage,0,3,A,0,1,A,L Doughty,9,21,2,9,4,14,5,4,1,1,0,0,10,10,1,3,30,11,9,18,2,0
15:00,Leyton Orient,Shrewsbury,1,0,H,1,0,H,L Smith,9,12,1,5,12,9,7,7,4,1,0,0,40,10,1,1,21,6,14,21,5,0
15:00,Northampton,Barnsley,1,2,A,0,1,A,A Young,12,9,5,4,9,13,10,2,0,4,0,0,0,40,1,3,21,9,12,22,4,0
15:00,Oxford,Exeter,3,0,H,1,0,H,D Middleton,9,14,4,5,11,13,3,4,1,1,0,0,10,10,1,3,23,9,7,24,2,0
15:00,Portsmouth,Lincoln,2,1,H,2,1,H,P Howard,11,10,3,4,7,11,3,1,3,2,0,0,30,20,3,3,21,7,4,18,5,0
15:00,Barnsley,Blackpool,0,1,A,0,1,A,C Breakspear,13,6,0,3,10,13,5,2,1,7,0,0,10,70,1,1,19,3,7,23,8,0
15:00,Derby,Cambridge,0,0,D,0,0,D,O Yates,12,4,2,1,11,12,9,3,2,2,0,0,20,20,0,0,16,3,12,23,4,0
15:00,Exeter,Northampton,0,2,A,0,1,A,N Hair,10,11,2,7,11,14,6,2,1,5,0,0,10,50,1,2,21,9,8,25,6,0
15:00,Fleetwood Town,Leyton Orient,1,0,H,0,0,D,S Mather,14,15,3,5,10,10,6,6,1,3,1,1,35,55,0,1,29,8,12,20,4,2
15:00,Lincoln,Cheltenham,2,0,H,2,0,H,B Atkinson,9,10,3,1,14,10,2,5,4,1,0,0,40,10,2,2,19,4,7,24,5,0
15:00,Peterboro,Bristol Rvs,2,0,H,1,0,H,B Toner,15,16,7,2,9,14,9,9,5,2,0,0,50,20,1,2,31,9,18,23,7,0
15:00,Port Vale,Bolton,0,1,A,0,1,A,D Bourne,15,13,6,5,6,14,8,5,2,3,0,0,20,30,1,1,28,11,13,20,5,0
15:00,Reading,Burton,0,0,D,0,0,D,S Purkiss,20,3,7,1,7,11,5,2,1,4,0,0,10,40,0,0,23,8,7,18,5,0
15:00,Shrewsbury,Charlton,0,0,D,0,0,D,E Duckworth,15,14,8,6,6,9,7,7,1,4,0,0,10,40,0,0,29,14,14,15,5,0
15:00,Stevenage,Oxford,1,3,A,1,1,D,C Brook,11,15,3,4,10,9,9,8,1,2,0,0,10,20,2,4,26,7,17,19,3,0
15:00,Wigan,Portsmouth,1,2,A,1,2,A,W Finnie,7,16,1,5,17,16,1,9,3,2,1,0,55,20,3,3,23,6,10,33,5,1
15:00,Wycombe,Carlisle,2,0,H,1,0,H,S Tallis,19,12,6,1,12,10,8,2,2,1,0,1,20,35,1,2,31,7,10,22,3,1
19:45,Blackpool,Derby,1,3,A,0,0,D,W Finnie,10,9,4,5,6,11,9,3,1,1,0,0,10,10,0,4,19,9,12,17,2,0
19:45,Bolton,Stevenage,3,2,H,1,1,D,J Smith,9,11,4,3,13,13,4,5,3,2,0,0,30,20,2,5,20,7,9,26,5,0
19:45,Bristol Rvs,Port Vale,3,0,H,2,0,H,B Speedie,10,6,7,2,11,13,8,3,1,1,0,1,10,35,2,3,16,9,11,24,2,1
19:45,Burton,Wigan,2,1,H,0,1,A,S Gill,15,12,5,1,14,16,3,4,2,3,1,0,45,30,1,3,27,6,7,30,5,1
19:45,Cambridge,Barnsley,0,4,A,0,2,A,T Parsons,17,12,8,7,7,12,6,6,2,2,0,0,20,20,2,4,29,15,12,19,4,0
19:45,Carlisle,Peterboro,1,1,D,0,0,D,S Simpson,8,15,1,6,8,14,3,8,2,0,0,0,20,0,0,2,23,7,11,22,2,0
19:45,Charlton,Exeter,4,1,H,1,1,D,D Rock,21,12,10,3,12,10,9,5,1,0,0,1,10,25,2,5,33,13,14,22,1,1
19:45,Cheltenham,Fleetwood Town,0,2,A,0,1,A,S Purkiss,7,20,2,5,16,11,0,3,2,5,1,0,45,50,1,2,27,7,3,27,7,1
19:45,Northampton,Reading,3,1,H,2,0,H,M Corlett,12,7,5,4,5,14,4,1,1,3,0,0,10,30,2,4,19,9,5,19,4,0
19:45,Oxford,Shrewsbury,3,0,H,1,0,H,C Breakspear,14,4,5,1,12,12,4,4,3,0,0,1,30,25,1,3,18,6,8,24,3,1
19:45,Portsmouth,Wycombe,2,1,H,0,1,A,A Young,11,8,3,1,8,13,14,2,2,4,0,0,20,40,1,3,19,4,16,21,6,0
12:30,Oxford,Bristol Rvs,2,1,H,1,0,H,S Mather,17,15,6,7,12,11,8,3,2,2,2,1,70,45,1,3,32,13,11,23,4,3
15:00,Bolton,Carlisle,1,3,A,1,1,D,S Stockbridge,12,15,3,9,11,9,7,7,2,3,0,0,20,30,2,4,27,12,14,20,5,0
15:00,Charlton,Blackpool,2,2,D,0,1,A,A Davies,18,9,5,4,5,6,5,3,2,3,0,0,20,30,1,4,27,9,8,11,5,0
15:00,Cheltenham,Derby,1,1,D,1,1,D,P Wright,6,17,2,8,17,8,1,8,1,0,0,0,10,0,2,2,23,10,9,25,1,0
15:00,Exeter,Barnsley,0,1,A,0,0,D,S Jackson,13,13,1,3,6,14,6,6,2,2,0,0,20,20,0,1,26,4,12,20,4,0
15:00,Fleetwood Town,Wycombe,1,4,A,0,3,A,R Joyce,9,17,4,12,14,5,5,3,2,2,1,0,45,20,3,5,26,16,8,19,4,1
15:00,Leyton Orient,Reading,2,1,H,1,1,D,N Hair,17,11,4,5,6,8,11,7,3,2,0,0,30,20,2,3,28,9,18,14,5,0
15:00,Peterboro,Lincoln,2,0,H,0,0,D,S Gill,13,12,5,0,10,8,6,4,1,2,0,0,10,20,0,2,25,5,10,18,3,0
15:00,Portsmouth,Port Vale,2,0,H,0,0,D,R Madley,13,14,4,3,8,14,6,6,1,3,0,0,10,30,0,2,27,7,12,22,4,0
15:00,Shrewsbury,Northampton,1,0,H,0,0,D,C Brook,13,17,2,2,9,13,3,10,1,3,0,0,10,30,0,1,30,4,13,22,4,0
15:00,Stevenage,Wigan,1,0,H,1,0,H,A Young,13,10,5,2,18,18,8,3,3,9,1,1,55,115,1,1,23,7,11,36,12,2
20:00,Burton,Cambridge,2,1,H,2,0,H,B Speedie,11,10,3,2,12,5,7,7,2,0,0,0,20,0,2,3,21,5,14,17,2,0
15:00,Blackpool,Stevenage,3,0,H,1,0,H,P Howard,14,7,3,3,9,7,6,7,1,3,0,0,10,30,1,3,21,6,13,16,4,0
15:00,Cambridge,Shrewsbury,1,1,D,0,0,D,S Tallis,10,15,1,2,11,10,4,5,2,1,0,0,20,10,0,2,25,3,9,21,3,0
15:00,Carlisle,Leyton Orient,0,1,A,0,1,A,E Duckworth,10,12,1,5,6,18,9,3,0,3,0,0,0,30,1,1,22,6,12,24,3,0
15:00,Lincoln,Burton,0,1,A,0,0,D,R Welch,10,6,3,1,8,9,4,4,1,4,1,0,35,40,0,1,16,4,8,17,5,1
15:00,Accrington,Charlton,2,2,D,0,1,A,B Speedie,22,11,6,3,12,13,6,4,3,0,0,0,30,0,1,4,33,9,10,25,3,0
15:00,Bristol Rvs,Forest Green,1,2,A,0,0,D,R Lewis,8,17,3,7,14,13,4,7,1,3,0,0,10,30,0,3,25,10,11,27,4,0
15:00,Cambridge,Milton Keynes Dons,1,0,H,1,0,H,J Busby,12,8,3,0,11,7,3,5,2,3,0,0,20,30,1,1,20,3,8,18,5,0
15:00,Cheltenham,Peterboro,2,3,A,2,0,H,T Nield,13,18,5,6,10,11,2,5,2,2,0,0,20,20,2,5,31,11,7,21,4,0
15:00,Derby,Oxford,1,0,H,0,0,D,A Backhouse,13,7,4,2,13,12,7,3,4,2,0,0,40,20,0,1,20,6,10,25,6,0
15:00,Ipswich,Bolton,1,1,D,1,1,D,S Barrott,17,4,5,1,13,14,8,6,2,2,0,0,20,20,2,2,21,6,14,27,4,0
15:00,Lincoln,Exeter,1,1,D,0,1,A,A Haines,11,7,2,2,6,11,8,4,1,2,0,0,10,20,1,2,18,4,12,17,3,0
15:00,Morecambe,Shrewsbury,0,0,D,0,0,D,M Edwards,7,17,2,1,12,13,4,3,2,2,0,0,20,20,0,0,24,3,7,25,4,0
15:00,Plymouth,Barnsley,1,0,H,1,0,H,C Breakspear,19,9,5,1,2,15,2,6,0,2,0,0,0,20,1,1,28,6,8,17,2,0
15:00,Port Vale,Fleetwood Town,2,1,H,2,1,H,P Wright,13,7,2,2,12,11,10,5,3,1,0,0,30,10,3,3,20,4,15,23,4,0
15:00,Sheffield Weds,Portsmouth,3,3,D,1,0,H,S Stockbridge,17,7,6,5,17,12,7,0,4,0,1,0,65,0,1,6,24,11,7,29,4,1
15:00,Wycombe,Burton,3,0,H,3,0,H,G Ward,16,11,7,1,6,6,2,5,0,0,0,0,0,0,3,3,27,8,7,12,0,0
15:00,Barnsley,Cheltenham,1,0,H,0,0,D,C Brook,13,7,3,2,13,10,8,1,0,4,0,0,0,40,0,1,20,5,9,23,4,0
15:00,Bolton,Wycombe,3,0,H,2,0,H,B Toner,21,17,6,3,12,6,4,7,0,2,0,0,0,20,2,3,38,9,11,18,2,0
15:00,Burton,Bristol Rvs,0,4,A,0,4,A,R Joyce,4,23,1,5,7,7,3,13,2,1,1,0,45,10,4,4,27,6,16,14,3,1
15:00,Charlton,Derby,1,0,H,0,0,D,C Pollard,14,13,7,2,11,7,5,4,2,1,0,0,20,10,0,1,27,9,9,18,3,0
15:00,Exeter,Port Vale,4,0,H,2,0,H,C Breakspear,18,6,7,2,11,8,4,7,2,0,0,0,20,0,2,4,24,9,11,19,2,0
15:00,Fleetwood Town,Plymouth,2,1,H,1,1,D,R Lewis,11,15,4,5,16,15,2,10,1,4,0,0,10,40,2,3,26,9,12,31,5,0
15:00,Forest Green,Ipswich,1,2,A,0,2,A,C Hicks,9,20,5,10,12,15,3,8,1,1,0,0,10,10,2,3,29,15,11,27,2,0
15:00,Milton Keynes Dons,Sheffield Weds,0,1,A,0,1,A,A Backhouse,10,15,5,4,8,14,5,3,0,4,0,0,0,40,1,1,25,9,8,22,4,0
15:00,Oxford,Cambridge,1,0,H,0,0,D,T Reeves,15,9,6,0,13,11,7,3,2,1,0,0,20,10,0,1,24,6,10,24,3,0
15:00,Peterboro,Morecambe,3,0,H,2,0,H,D Whitestone,18,7,9,2,16,10,9,2,1,1,0,0,10,10,2,3,25,11,11,26,2,0
15:00,Portsmouth,Lincoln,0,0,D,0,0,D,D Rock,16,4,6,0,10,15,3,4,0,1,0,0,0,10,0,0,20,6,7,25,1,0
15:00,Shrewsbury,Accrington,0,1,A,0,0,D,A Haines,13,11,4,2,13,7,8,7,0,2,1,0,25,20,0,1,24,6,15,20,2,1
12:30,Bristol Rvs,Oxford,1,0,H,1,0,H,O Langford,6,7,3,2,11,12,7,4,2,3,0,0,20,30,1,1,13,5,11,23,5,0
15:00,Accrington,Burton,4,4,D,0,2,A,S Barrott,20,15,8,5,8,15,4,4,0,0,0,0,0,0,2,8,35,13,8,23,0,0
15:00,Cambridge,Exeter,2,1,H,0,1,A,S Purkiss,16,17,5,2,4,8,8,7,3,2,0,0,30,20,1,3,33,7,15,12,5,0
15:00,Cheltenham,Portsmouth,0,2,A,0,1,A,B Toner,13,16,2,5,10,16,5,3,2,1,0,0,20,10,1,2,29,7,8,26,3,0
15:00,Derby,Barnsley,2,1,H,2,0,H,P Wright,6,8,2,2,7,13,6,5,1,1,0,0,10,10,2,3,14,4,11,20,2,0
15:00,Ipswich,Milton Keynes Dons,3,0,H,2,0,H,C Brook,18,6,9,2,8,6,10,3,0,1,0,0,0,10,2,3,24,11,13,14,1,0
15:00,Lincoln,Forest Green,1,1,D,0,0,D,D Bourne,17,9,3,4,9,8,5,4,3,3,0,0,30,30,0,2,26,7,9,17,6,0
15:00,Morecambe,Fleetwood Town,1,1,D,1,0,H,S Stockbridge,15,19,7,5,13,11,5,7,2,1,0,1,20,35,1,2,34,12,12,24,3,1
15:00,Plymouth,Peterboro,2,0,H,1,0,H,T Reeves,17,5,8,3,11,15,5,5,2,2,0,0,20,20,1,2,22,11,10,26,4,0
15:00,Port Vale,Bolton,0,0,D,0,0,D,R Joyce,17,13,4,5,9,11,3,7,2,1,0,1,20,35,0,0,30,9,10,20,3,1
15:00,Sheffield Weds,Charlton,1,0,H,0,0,D,B Madden,7,11,2,3,16,13,3,3,1,1,0,0,10,10,0,1,18,5,6,29,2,0
15:00,Wycombe,Shrewsbury,1,2,A,0,0,D,L Swabey,18,6,9,2,7,13,12,4,3,0,0,0,30,0,0,3,24,11,16,20,3,0
19:45,Barnsley,Bristol Rvs,3,0,H,2,0,H,D Drysdale,16,7,5,0,14,8,6,2,0,3,0,0,0,30,2,3,23,5,8,22,3,0
19:45,Bolton,Morecambe,1,0,H,1,0,H,A Backhouse,16,9,3,1,6,11,7,1,1,1,0,0,10,10,1,1,25,4,8,17,2,0
19:45,Burton,Ipswich,0,1,A,0,0,D,B Toner,14,16,4,3,13,9,5,12,1,2,0,0,10,20,0,1,30,7,17,22,3,0
19:45,Charlton,Plymouth,5,1,H,3,0,H,S Purkiss,19,13,9,4,9,9,6,3,0,0,0,1,0,25,3,6,32,13,9,18,0,1
19:45,Exeter,Wycombe,3,1,H,2,0,H,J Busby,15,11,5,5,8,9,10,2,0,3,0,0,0,30,2,4,26,10,12,17,3,0
19:45,Fleetwood Town,Cheltenham,0,0,D,0,0,D,A Kitchen,14,15,5,2,9,8,6,5,7,3,0,0,70,30,0,0,29,7,11,17,10,0
19:45,Milton Keynes Dons,Port Vale,2,1,H,1,0,H,T Nield,9,11,5,3,9,14,4,4,1,1,0,0,10,10,1,3,20,8,8,23,2,0
19:45,Oxford,Lincoln,1,2,A,0,2,A,S Barrott,15,5,5,3,14,16,10,2,2,3,0,0,20,30,2,3,20,8,12,30,5,0
19:45,Peterboro,Sheffield Weds,2,0,H,0,0,D,J Oldham,20,9,6,2,7,12,9,7,1,2,0,1,10,45,0,2,29,8,16,19,3,1
19:45,Portsmouth,Cambridge,4,1,H,1,1,D,C Pollard,9,6,5,4,8,19,1,4,0,3,0,0,0,30,2,5,15,9,5,27,3,0
19:45,Shrewsbury,Derby,0,0,D,0,0,D,S Oldham,10,12,1,4,9,8,5,10,3,1,0,0,30,10,0,0,22,5,15,17,4,0
15:00,Barnsley,Wycombe,0,3,A,0,1,A,O Yates,12,14,5,8,8,12,7,5,3,2,0,0,30,20,1,3,26,13,12,20,5,0
15:00,Bolton,Sheffield Weds,0,2,A,0,2,A,C Breakspear,9,9,3,3,8,13,4,1,2,1,0,0,20,10,2,2,18,6,5,21,3,0
15:00,Burton,Port Vale,0,2,A,0,0,D,A Haines,11,12,3,7,9,6,7,6,0,0,0,0,0,0,0,2,23,10,13,15,0,0
15:00,Charlton,Cambridge,1,1,D,1,0,H,C Brook,15,10,5,4,8,4,8,4,1,2,0,0,10,20,1,2,25,9,12,12,3,0
15:00,Exeter,Cheltenham,0,1,A,0,0,D,R Lewis,16,4,6,3,13,8,12,0,0,4,0,0,0,40,0,1,20,9,12,21,4,0
15:00,Fleetwood Town,Derby,0,0,D,0,0,D,R Joyce,7,27,2,8,13,5,5,13,1,1,0,0,10,10,0,0,34,10,18,18,2,0
15:00,Forest Green,Plymouth,0,3,A,0,2,A,D Drysdale,10,8,6,5,10,9,6,2,1,1,0,0,10,10,2,3,18,11,8,19,2,0
15:00,Milton Keynes Dons,Accrington,1,1,D,1,0,H,T Reeves,10,16,4,4,15,16,2,5,2,4,0,0,20,40,1,2,26,8,7,31,6,0
15:00,Oxford,Morecambe,1,1,D,0,0,D,B Speedie,27,3,10,1,12,18,8,0,2,4,0,0,20,40,0,2,30,11,8,30,6,0
15:00,Peterboro,Lincoln,4,0,H,3,0,H,R Welch,14,4,10,1,12,12,4,5,1,2,0,0,10,20,3,4,18,11,9,24,3,0
15:00,Portsmouth,Bristol Rvs,3,1,H,1,0,H,G Ward,23,8,7,2,9,14,12,2,3,5,0,0,30,50,1,4,31,9,14,23,8,0
15:00,Shrewsbury,Ipswich,0,3,A,0,1,A,W Finnie,4,13,1,6,9,11,2,8,1,1,0,0,10,10,1,3,17,7,10,20,2,0
15:00,Accrington,Exeter,0,0,D,0,0,D,S Stockbridge,18,7,2,0,10,15,4,6,1,1,0,0,10,10,0,0,25,2,10,25,2,0
15:00,Bristol Rvs,Shrewsbury,1,1,D,0,0,D,S Purkiss,9,20,2,5,12,9,4,9,1,1,0,0,10,10,0,2,29,7,13,21,2,0
15:00,Cambridge,Burton,4,3,H,1,2,A,B Speedie,21,12,9,3,8,20,6,5,2,4,0,1,20,65,3,7,33,12,11,28,6,1
15:00,Cheltenham,Oxford,1,2,A,0,0,D,C Breakspear,7,14,4,5,12,10,3,6,4,3,1,1,65,55,0,3,21,9,9,22,7,2
15:00,Derby,Peterboro,2,1,H,0,0,D,B Madden,16,13,5,4,12,14,8,4,1,2,0,1,10,45,0,3,29,9,12,26,3,1
15:00,Ipswich,Barnsley,2,2,D,1,1,D,S Martin,12,9,7,4,13,15,4,2,2,4,0,0,20,40,2,4,21,11,6,28,6,0
15:00,Lincoln,Fleetwood Town,2,2,D,2,1,H,O Yates,6,19,4,9,11,15,3,6,3,4,0,0,30,40,3,4,25,13,9,26,7,0
15:00,Morecambe,Milton Keynes Dons,0,4,A,0,2,A,S Barrott,17,17,5,10,13,13,6,3,0,0,0,0,0,0,2,4,34,15,9,26,0,0
15:00,Plymouth,Bolton,2,0,H,1,0,H,W Finnie,9,14,4,4,9,10,2,10,2,1,0,0,20,10,1,2,23,8,12,19,3,0
15:00,Port Vale,Portsmouth,0,1,A,0,1,A,C Hicks,8,11,4,1,10,13,3,4,2,1,0,0,20,10,1,1,19,5,7,23,3,0
15:00,Sheffield Weds,Forest Green,5,0,H,4,0,H,S Mather,15,3,8,0,7,11,4,1,1,3,0,0,10,30,4,5,18,8,5,18,4,0
15:00,Wycombe,Charlton,1,1,D,1,1,D,D Rock,16,9,4,2,12,6,9,2,4,3,0,0,40,30,2,2,25,6,11,18,7,0
15:00,Accrington,Ipswich,0,2,A,0,0,D,A Backhouse,10,18,3,7,17,9,6,12,3,3,0,0,30,30,0,2,28,10,18,26,6,0
15:00,Bolton,Charlton,3,1,H,2,1,H,T Reeves,17,9,5,5,12,9,5,5,2,1,0,0,20,10,3,4,26,10,10,21,3,0
15:00,Bristol Rvs,Morecambe,2,2,D,1,1,D,D Whitestone,23,8,7,4,10,14,11,2,2,1,0,0,20,10,2,4,31,11,13,24,3,0
15:00,Cambridge,Lincoln,2,0,H,2,0,H,S Allison,9,6,2,4,9,10,4,1,0,1,0,0,0,10,2,2,15,6,5,19,1,0
15:00,Derby,Plymouth,2,3,A,2,0,H,O Yates,12,13,3,6,11,9,4,6,1,1,0,0,10,10,2,5,25,9,10,20,2,0
15:00,Exeter,Milton Keynes Dons,1,0,H,0,0,D,B Toner,15,4,4,3,9,8,8,0,1,1,0,0,10,10,0,1,19,7,8,17,2,0
15:00,Fleetwood Town,Wycombe,1,1,D,0,1,A,J Oldham,20,7,5,5,10,8,12,2,1,1,0,1,10,35,1,2,27,10,14,18,2,1
15:00,Forest Green,Shrewsbury,0,2,A,0,1,A,P Wright,14,5,6,4,11,16,6,5,3,2,0,0,30,20,1,2,19,10,11,27,5,0
15:00,Oxford,Burton,2,1,H,0,0,D,B Madden,8,9,4,1,9,13,4,6,1,2,0,0,10,20,0,3,17,5,10,22,3,0
15:00,Port Vale,Cheltenham,2,2,D,2,1,H,R Welch,10,6,3,2,7,10,2,1,0,0,0,0,0,0,3,4,16,5,3,17,0,0
15:00,Portsmouth,Peterboro,2,1,H,1,1,D,S Barrott,13,10,2,3,13,13,1,7,2,1,0,0,20,10,2,3,23,5,8,26,3,0
15:00,Sheffield Weds,Barnsley,0,2,A,0,1,A,J Smith,11,14,3,5,13,11,10,1,2,4,0,0,20,40,1,2,25,8,11,24,6,0
19:45,Forest Green,Accrington,2,1,H,1,0,H,A Woolmer,12,17,5,4,7,21,1,8,3,1,0,0,30,10,1,3,29,9,9,28,4,0
19:45,Barnsley,Port Vale,1,1,D,1,0,H,T Parsons,17,15,5,4,15,7,9,7,4,0,0,0,40,0,1,2,32,9,16,22,4,0
19:45,Burton,Portsmouth,0,2,A,0,0,D,R Lewis,9,13,1,2,13,10,4,4,2,1,0,0,20,10,0,2,22,3,8,23,3,0
19:45,Charlton,Forest Green,1,1,D,1,1,D,J Busby,17,9,6,2,15,10,4,6,2,3,1,0,45,30,2,2,26,8,10,25,5,1
19:45,Cheltenham,Cambridge,2,1,H,0,1,A,K Stroud,13,8,5,2,10,9,6,3,3,2,0,0,30,20,1,3,21,7,9,19,5,0
19:45,Ipswich,Bristol Rvs,2,0,H,1,0,H,A Young,19,5,7,3,12,11,7,1,3,1,0,2,30,60,1,2,24,10,8,23,4,2
19:45,Lincoln,Derby,2,0,H,1,0,H,T Kirk,11,10,4,5,9,9,4,4,3,2,0,0,30,20,1,2,21,9,8,18,5,0
19:45,Milton Keynes Dons,Bolton,0,2,A,0,1,A,C Pollard,4,9,0,4,12,14,3,5,1,1,0,0,10,10,1,2,13,4,8,26,2,0
19:45,Morecambe,Sheffield Weds,0,3,A,0,0,D,A Kitchen,4,29,1,11,7,2,3,9,0,1,0,0,0,10,0,3,33,12,12,9,1,0
19:45,Peterboro,Fleetwood Town,0,1,A,0,1,A,W Finnie,19,8,5,3,12,12,11,5,3,2,0,0,30,20,1,1,27,8,16,24,5,0
19:45,Plymouth,Oxford,1,0,H,0,0,D,C Hicks,22,8,5,1,11,14,8,3,1,2,0,0,10,20,0,1,30,6,11,25,3,0
19:45,Shrewsbury,Exeter,3,2,H,2,2,D,M Woods,18,15,7,5,7,7,5,10,0,1,0,0,0,10,4,5,33,12,15,14,1,0
19:45,Wycombe,Accrington,1,0,H,1,0,H,D Drysdale,13,18,7,4,15,6,3,11,1,2,0,0,10,20,1,1,31,11,14,21,3,0
15:00,Accrington,Cheltenham,1,0,H,1,0,H,S Martin,13,11,3,1,8,14,6,4,3,2,0,0,30,20,1,1,24,4,10,22,5,0
15:00,Bolton,Peterboro,1,0,H,0,0,D,C Brook,7,3,3,0,17,16,6,4,4,3,0,0,40,30,0,1,10,3,10,33,7,0
15:00,Bristol Rvs,Lincoln,3,6,A,1,3,A,T Nield,15,13,7,8,9,10,9,5,2,0,0,0,20,0,4,9,28,15,14,19,2,0
15:00,Cambridge,Barnsley,0,3,A,0,1,A,D Bourne,9,10,4,5,6,11,3,5,2,2,0,1,20,45,1,3,19,9,8,17,4,1
15:00,Derby,Wycombe,2,1,H,0,1,A,S Barrott,26,12,12,5,4,12,8,5,1,2,0,0,10,20,1,3,38,17,13,16,3,0
15:00,Exeter,Burton,0,2,A,0,0,D,N Hair,15,17,2,5,12,15,5,7,2,4,0,0,20,40,0,2,32,7,12,27,6,0
15:00,Fleetwood Town,Charlton,1,1,D,1,0,H,S Mather,14,7,2,3,12,14,6,2,1,1,0,0,10,10,1,2,21,5,8,26,2,0
15:00,Forest Green,Morecambe,1,2,A,1,1,D,O Yates,9,15,4,8,9,14,9,7,2,1,0,0,20,10,2,3,24,12,16,23,3,0
15:00,Oxford,Milton Keynes Dons,1,2,A,0,1,A,A Kitchen,19,6,5,4,11,10,5,2,0,1,0,0,0,10,1,3,25,9,7,21,1,0
15:00,Port Vale,Shrewsbury,2,1,H,1,1,D,B Speedie,12,7,3,1,11,12,6,2,2,3,0,0,20,30,2,3,19,4,8,23,5,0
15:00,Portsmouth,Plymouth,2,2,D,1,0,H,J Bell,12,8,6,4,10,8,2,3,4,1,0,1,40,35,1,4,20,10,5,18,5,1
15:00,Sheffield Weds,Ipswich,2,2,D,0,1,A,P Wright,11,11,2,4,9,20,3,2,2,6,0,0,20,60,1,4,22,6,5,29,8,0
12:30,Forest Green,Exeter,0,4,A,0,3,A,B Speedie,8,13,3,6,10,10,3,8,3,1,0,0,30,10,3,4,21,9,11,20,4,0
15:00,Barnsley,Charlton,3,1,H,1,0,H,A Herczeg,9,12,3,1,12,9,4,8,0,0,0,0,0,0,1,4,21,4,12,21,0,0
15:00,Bristol Rvs,Accrington,0,1,A,0,0,D,L Swabey,14,15,3,4,9,15,4,11,2,3,0,0,20,30,0,1,29,7,15,24,5,0
15:00,Morecambe,Cambridge,1,2,A,1,1,D,B Madden,8,20,4,6,18,5,0,13,1,0,0,0,10,0,2,3,28,10,13,23,1,0
15:00,Peterboro,Port Vale,3,0,H,2,0,H,A Backhouse,23,9,6,1,5,6,5,3,0,3,0,0,0,30,2,3,32,7,8,11,3,0
15:00,Sheffield Weds,Wycombe,3,1,H,2,1,H,M Donohue,10,7,7,4,10,13,12,5,0,2,0,0,0,20,3,4,17,11,17,23,2,0
15:00,Shrewsbury,Burton,2,1,H,1,0,H,T Kirk,6,17,2,7,7,6,3,9,1,1,0,0,10,10,1,3,23,9,12,13,2,0
12:30,Plymouth,Ipswich,2,1,H,0,1,A,S Oldham,12,17,5,7,9,16,5,4,0,4,0,0,0,40,1,3,29,12,9,25,4,0
15:00,Accrington,Morecambe,3,1,H,0,0,D,J Oldham,11,8,5,2,8,12,6,4,2,4,0,1,20,65,0,4,19,7,10,20,6,1
15:00,Bolton,Lincoln,2,0,H,1,0,H,N Hair,9,7,5,2,9,13,6,5,3,2,0,0,30,20,1,2,16,7,11,22,5,0
15:00,Burton,Forest Green,3,2,H,1,0,H,S Gill,14,8,6,3,10,7,9,4,1,0,1,0,35,0,1,5,22,9,13,17,1,1
15:00,Cambridge,Derby,0,2,A,0,1,A,S Mather,5,13,1,3,8,8,2,2,0,1,0,0,0,10,1,2,18,4,4,16,1,0
15:00,Charlton,Oxford,1,1,D,0,1,A,R Madley,11,11,4,3,8,16,1,2,3,1,0,0,30,10,1,2,22,7,3,24,4,0
15:00,Cheltenham,Shrewsbury,2,0,H,1,0,H,C Brook,10,4,3,0,17,11,4,2,1,1,0,0,10,10,1,2,14,3,6,28,2,0
15:00,Exeter,Bristol Rvs,2,2,D,0,0,D,D Bourne,10,9,4,4,11,15,6,3,2,2,0,0,20,20,0,4,19,8,9,26,4,0
15:00,Fleetwood Town,Barnsley,0,1,A,0,0,D,S Barrott,4,12,1,4,12,9,5,5,4,1,0,0,40,10,0,1,16,5,10,21,5,0
15:00,Ipswich,Portsmouth,3,2,H,1,1,D,C Breakspear,18,7,6,3,13,12,8,4,1,2,0,0,10,20,2,5,25,9,12,25,3,0
15:00,Milton Keynes Dons,Peterboro,2,3,A,0,2,A,O Yates,7,20,4,9,15,13,5,9,3,1,0,0,30,10,2,5,27,13,14,28,4,0
15:00,Port Vale,Sheffield Weds,0,1,A,0,0,D,C Pollard,12,10,3,3,14,12,7,5,3,1,0,0,30,10,0,1,22,6,12,26,4,0
15:00,Wycombe,Plymouth,0,1,A,0,1,A,J Busby,18,17,6,3,12,6,12,7,0,1,0,0,0,10,1,1,35,9,19,18,1,0
19:45,Burton,Fleetwood Town,0,1,A,0,1,A,C Breakspear,14,15,3,4,14,11,8,5,1,2,0,0,10,20,1,1,29,7,13,25,3,0
19:45,Cheltenham,Bolton,1,0,H,0,0,D,G Ward,14,3,5,0,8,7,10,5,2,2,0,0,20,20,0,1,17,5,15,15,4,0
19:45,Ipswich,Cambridge,3,0,H,0,0,D,R Lewis,12,4,5,0,10,8,4,1,1,0,0,0,10,0,0,3,16,5,5,18,1,0
19:45,Plymouth,Sheffield Weds,2,1,H,1,1,D,A Davies,24,13,8,6,4,15,7,5,2,1,0,0,20,10,2,3,37,14,12,19,3,0
15:00,Barnsley,Exeter,0,2,A,0,1,A,M Coy,15,9,4,3,5,7,7,4,0,1,0,0,0,10,1,2,24,7,11,12,1,0
15:00,Bristol Rvs,Cambridge,2,1,H,1,1,D,B Toner,15,17,6,5,7,11,7,4,4,2,0,0,40,20,2,3,32,11,11,18,6,0
15:00,Derby,Port Vale,1,2,A,1,0,H,S Allison,13,20,3,3,15,13,7,7,1,3,1,0,35,30,1,3,33,6,14,28,4,1
15:00,Forest Green,Bolton,1,0,H,1,0,H,M Edwards,6,10,4,2,13,10,2,10,4,0,0,0,40,0,1,1,16,6,12,23,4,0
15:00,Lincoln,Charlton,0,0,D,0,0,D,R Lewis,6,4,1,1,12,10,10,6,1,1,0,0,10,10,0,0,10,2,16,22,2,0
15:00,Morecambe,Ipswich,1,2,A,1,0,H,T Kirk,7,17,2,6,22,9,2,4,5,1,0,0,50,10,1,3,24,8,6,31,6,0
15:00,Oxford,Wycombe,0,1,A,0,1,A,K Stroud,29,6,5,2,10,12,11,3,2,3,0,0,20,30,1,1,35,7,14,22,5,0
15:00,Peterboro,Burton,1,1,D,0,0,D,S Stockbridge,25,9,3,4,6,9,8,2,0,1,0,0,0,10,0,2,34,7,10,15,1,0
15:00,Plymouth,Accrington,3,0,H,1,0,H,N Hair,14,11,5,3,15,17,4,5,4,3,1,1,65,55,1,3,25,8,9,32,7,2
15:00,Portsmouth,Fleetwood Town,1,1,D,1,1,D,J Oldham,18,5,2,2,15,19,6,5,2,5,0,0,20,50,2,2,23,4,11,34,7,0
15:00,Sheffield Weds,Cheltenham,3,0,H,1,0,H,B Speedie,24,6,9,3,8,9,7,2,0,4,0,0,0,40,1,3,30,12,9,17,4,0
15:00,Shrewsbury,Milton Keynes Dons,2,1,H,2,0,H,A Woolmer,10,13,5,2,7,12,7,12,1,2,0,1,10,45,2,3,23,7,19,19,3,1
19:45,Charlton,Exeter,4,2,H,2,1,H,C Hicks,15,12,6,4,8,9,4,6,1,0,0,0,10,0,3,6,27,10,10,17,1,0
19:45,Milton Keynes Dons,Bristol Rvs,0,1,A,0,0,D,S Oldham,4,13,1,3,16,13,0,6,3,2,0,0,30,20,0,1,17,4,6,29,5,0
19:45,Peterboro,Forest Green,4,1,H,2,1,H,D Handley,21,8,7,2,16,12,7,5,1,1,0,0,10,10,3,5,29,9,12,28,2,0
15:00,Accrington,Derby,0,3,A,0,2,A,W Finnie,8,14,1,7,7,14,5,6,1,2,0,0,10,20,2,3,22,8,11,21,3,0
15:00,Bolton,Barnsley,0,0,D,0,0,D,D Rock,7,6,1,2,9,11,8,2,3,2,0,0,30,20,0,0,13,3,10,20,5,0
15:00,Burton,Morecambe,1,1,D,1,0,H,D Handley,15,6,3,4,6,14,6,2,0,5,0,0,0,50,1,2,21,7,8,20,5,0
15:00,Cambridge,Sheffield Weds,0,2,A,0,1,A,C Boyeson,11,15,1,8,9,17,6,6,1,3,0,0,10,30,1,2,26,9,12,26,4,0
15:00,Cheltenham,Bristol Rvs,1,4,A,0,4,A,S Barrott,10,5,4,4,10,6,7,2,0,1,0,0,0,10,4,5,15,8,9,16,1,0
15:00,Exeter,Oxford,2,4,A,0,3,A,T Kirk,10,19,3,9,10,12,5,4,3,1,0,0,30,10,3,6,29,12,9,22,4,0
15:00,Fleetwood Town,Shrewsbury,0,1,A,0,1,A,T Parsons,22,10,7,2,17,11,7,2,4,5,0,0,40,50,1,1,32,9,9,28,9,0
15:00,Ipswich,Lincoln,0,1,A,0,1,A,A Davies,33,3,5,2,2,9,14,4,1,0,0,0,10,0,1,1,36,7,18,11,1,0
15:00,Milton Keynes Dons,Plymouth,1,4,A,0,3,A,S Allison,10,16,3,7,8,8,1,3,2,0,0,0,20,0,3,5,26,10,4,16,2,0
15:00,Port Vale,Forest Green,2,2,D,0,2,A,M Woods,20,9,7,3,8,15,13,2,3,5,0,0,30,50,2,4,29,10,15,23,8,0
15:00,Wycombe,Peterboro,3,1,H,1,1,D,C Breakspear,15,13,4,7,17,8,4,5,2,0,0,0,20,0,2,4,28,11,9,25,2,0
20:00,Charlton,Portsmouth,3,0,H,2,0,H,D Whitestone,11,10,6,3,16,7,8,8,3,1,0,1,30,35,2,3,21,9,16,23,4,1
20:00,Ipswich,Derby,1,0,H,0,0,D,L Swabey,16,5,3,0,13,15,11,3,2,2,0,0,20,20,0,1,21,3,14,28,4,0
13:00,Lincoln,Sheffield Weds,1,1,D,0,1,A,A Young,6,17,3,3,10,11,3,6,2,2,0,0,20,20,1,2,23,6,9,21,4,0
15:00,Accrington,Bolton,2,3,A,1,0,H,B Madden,13,17,5,7,17,12,4,7,4,1,0,0,40,10,1,5,30,12,11,29,5,0
15:00,Bristol Rvs,Plymouth,2,2,D,0,2,A,C Pollard,17,10,6,3,10,14,8,7,1,4,0,0,10,40,2,4,27,9,15,24,5,0
15:00,Burton,Cheltenham,1,0,H,0,0,D,P Wright,16,4,5,1,8,13,6,1,1,2,0,0,10,20,0,1,20,6,7,21,3,0
15:00,Cambridge,Port Vale,0,1,A,0,0,D,T Kirk,8,10,0,4,12,9,4,6,1,3,0,0,10,30,0,1,18,4,10,21,4,0
15:00,Exeter,Fleetwood Town,2,1,H,1,1,D,T Nield,8,13,5,3,9,8,3,5,0,1,0,0,0,10,2,3,21,8,8,17,1,0
15:00,Forest Green,Portsmouth,0,1,A,0,1,A,W Finnie,9,16,1,5,14,10,3,7,3,2,0,0,30,20,1,1,25,6,10,24,5,0
15:00,Milton Keynes Dons,Wycombe,0,1,A,0,1,A,O Langford,14,11,7,4,8,9,6,2,1,1,0,0,10,10,1,1,25,11,8,17,2,0
15:00,Morecambe,Barnsley,1,0,H,1,0,H,S Mather,5,14,1,3,11,7,3,6,3,2,0,0,30,20,1,1,19,4,9,18,5,0
15:00,Oxford,Peterboro,1,2,A,0,2,A,A Woolmer,12,8,2,4,20,16,6,4,3,3,1,0,55,30,2,3,20,6,10,36,6,1
15:00,Shrewsbury,Charlton,0,1,A,0,0,D,S Stockbridge,9,17,2,4,15,8,9,4,1,3,0,0,10,30,0,1,26,6,13,23,4,0
19:45,Barnsley,Lincoln,0,1,A,0,1,A,J Oldham,13,7,2,1,9,8,6,2,2,1,0,0,20,10,1,1,20,3,8,17,3,0
19:45,Bolton,Burton,2,1,H,0,0,D,S Allison,16,13,6,4,10,16,6,8,2,1,0,0,20,10,0,3,29,10,14,26,3,0
19:45,Charlton,Milton Keynes Dons,0,2,A,0,0,D,N Hair,7,8,1,6,13,10,1,2,0,0,1,0,25,0,0,2,15,7,3,23,0,1
19:45,Cheltenham,Morecambe,1,0,H,1,0,H,S Oldham,17,5,5,1,7,13,3,2,0,3,0,0,0,30,1,1,22,6,5,20,3,0
19:45,Derby,Exeter,0,0,D,0,0,D,A Herczeg,10,4,3,1,9,11,8,4,2,3,0,0,20,30,0,0,14,4,12,20,5,0
19:45,Fleetwood Town,Forest Green,1,1,D,0,1,A,A Backhouse,17,11,4,4,12,9,8,3,2,2,0,0,20,20,1,2,28,8,11,21,4,0
19:45,Peterboro,Accrington,3,1,H,1,1,D,C Hicks,14,18,6,5,11,19,7,3,2,4,0,0,20,40,2,4,32,11,10,30,6,0
19:45,Plymouth,Shrewsbury,2,1,H,0,1,A,A Woolmer,17,14,5,3,9,9,9,5,1,2,0,0,10,20,1,3,31,8,14,18,3,0
19:45,Port Vale,Ipswich,2,3,A,1,2,A,A Kitchen,10,14,3,7,12,14,4,6,0,0,0,0,0,0,3,5,24,10,10,26,0,0
19:45,Portsmouth,Oxford,1,1,D,0,1,A,S Purkiss,19,10,4,2,9,21,6,5,1,3,0,1,10,55,1,2,29,6,11,30,4,1
19:45,Wycombe,Cambridge,2,3,A,1,2,A,P Wright,22,10,6,5,12,9,11,2,2,2,0,0,20,20,3,5,32,11,13,21,4,0
20:00,Sheffield Weds,Bristol Rvs,1,1,D,1,0,H,O Langford,22,10,6,5,10,10,7,1,1,1,0,0,10,10,1,2,32,11,8,20,2,0
15:00,Barnsley,Forest Green,2,0,H,1,0,H,B Madden,18,3,6,0,15,10,9,3,1,0,0,0,10,0,1,2,21,6,12,25,1,0
15:00,Bolton,Oxford,1,3,A,0,1,A,O Yates,10,12,3,5,13,18,4,4,2,5,0,0,20,50,1,4,22,8,8,31,7,0
15:00,Charlton,Ipswich,4,4,D,0,1,A,J Smith,9,18,7,5,14,20,1,5,2,5,0,0,20,50,1,8,27,12,6,34,7,0
15:00,Cheltenham,Milton Keynes Dons,0,0,D,0,0,D,D Drysdale,14,15,3,8,7,8,3,6,1,3,0,0,10,30,0,0,29,11,9,15,4,0
15:00,Derby,Bristol Rvs,4,2,H,4,2,H,M Coy,16,10,5,6,14,8,7,4,4,1,0,0,40,10,6,6,26,11,11,22,5,0
15:00,Fleetwood Town,Accrington,3,0,H,0,0,D,G Eltringham,12,15,4,2,10,9,9,5,3,1,0,0,30,10,0,3,27,6,14,19,4,0
15:00,Peterboro,Cambridge,1,0,H,1,0,H,S Oldham,19,10,3,4,9,15,6,0,1,3,0,0,10,30,1,1,29,7,6,24,4,0
15:00,Port Vale,Lincoln,1,0,H,0,0,D,S Gill,16,2,5,1,7,8,8,4,3,2,0,0,30,20,0,1,18,6,12,15,5,0
15:00,Portsmouth,Shrewsbury,1,1,D,1,1,D,T Reeves,16,4,3,1,14,10,7,1,1,0,0,0,10,0,2,2,20,4,8,24,1,0
15:00,Sheffield Weds,Burton,4,2,H,2,0,H,D Rock,16,11,7,4,9,7,7,1,0,0,0,0,0,0,2,6,27,11,8,16,0,0
15:00,Wycombe,Morecambe,1,1,D,1,0,H,A Young,14,16,4,5,11,7,13,3,2,3,0,0,20,30,1,2,30,9,16,18,5,0
20:00,Plymouth,Exeter,4,2,H,1,1,D,C Breakspear,10,10,5,5,4,10,6,7,0,0,0,0,0,0,2,6,20,10,13,14,0,0
19:45,Lincoln,Accrington,1,1,D,0,0,D,R Joyce,9,10,7,3,9,11,7,8,3,4,0,0,30,40,0,2,19,10,15,20,7,0
19:45,Morecambe,Derby,1,1,D,1,0,H,M Edwards,10,27,5,11,9,5,3,11,2,2,0,0,20,20,1,2,37,16,14,14,4,0
19:45,Oxford,Fleetwood Town,1,1,D,0,1,A,A Young,21,10,6,6,12,9,7,3,3,3,0,0,30,30,1,2,31,12,10,21,6,0
19:45,Wycombe,Port Vale,2,2,D,1,1,D,R Lewis,13,12,5,4,14,13,6,4,2,1,0,0,20,10,2,4,25,9,10,27,3,0
19:45,Shrewsbury,Oxford,1,1,D,0,1,A,M Woods,12,11,5,5,14,12,12,0,3,2,0,0,30,20,1,2,23,10,12,26,5,0
15:00,Accrington,Sheffield Weds,0,1,A,0,1,A,C Breakspear,9,18,4,5,9,13,3,8,1,3,0,0,10,30,1,1,27,9,11,22,4,0
15:00,Bristol Rvs,Fleetwood Town,2,2,D,0,1,A,B Madden,13,13,3,5,15,14,8,2,4,2,0,0,40,20,1,4,26,8,10,29,6,0
15:00,Burton,Charlton,3,3,D,2,2,D,W Finnie,25,12,10,4,10,9,12,4,1,0,0,0,10,0,4,6,37,14,16,19,1,0
15:00,Cambridge,Bolton,0,0,D,0,0,D,D Drysdale,10,14,5,1,10,15,9,5,2,4,0,1,20,65,0,0,24,6,14,25,6,1
15:00,Exeter,Peterboro,3,2,H,1,1,D,T Reeves,6,16,4,7,9,9,4,4,3,0,0,0,30,0,2,5,22,11,8,18,3,0
15:00,Forest Green,Wycombe,0,2,A,0,2,A,S Purkiss,14,16,1,4,8,21,6,6,4,3,0,0,40,30,2,2,30,5,12,29,7,0
15:00,Ipswich,Cheltenham,1,1,D,1,1,D,G Eltringham,29,3,4,1,9,6,15,0,1,3,0,0,10,30,2,2,32,5,15,15,4,0
15:00,Lincoln,Plymouth,1,1,D,1,1,D,C Hicks,17,16,8,7,10,15,3,5,0,3,0,0,0,30,2,2,33,15,8,25,3,0
15:00,Milton Keynes Dons,Derby,1,3,A,1,1,D,J Linington,13,8,4,3,7,12,6,9,3,3,0,0,30,30,2,4,21,7,15,19,6,0
15:00,Morecambe,Portsmouth,1,1,D,1,0,H,A Herczeg,15,14,4,5,13,12,5,8,3,3,0,0,30,30,1,2,29,9,13,25,6,0
15:00,Oxford,Port Vale,4,0,H,2,0,H,D Rock,21,14,8,2,17,10,3,9,1,3,0,0,10,30,2,4,35,10,12,27,4,0
15:00,Shrewsbury,Barnsley,0,1,A,0,1,A,C Pollard,9,14,1,2,6,10,6,3,5,2,0,0,50,20,1,1,23,3,9,16,7,0
20:00,Portsmouth,Derby,0,0,D,0,0,D,B Speedie,10,13,1,3,16,12,2,5,2,4,0,0,20,40,0,0,23,4,7,28,6,0
12:00,Exeter,Ipswich,0,2,A,0,1,A,A Young,7,13,1,6,6,8,6,7,1,2,0,0,10,20,1,2,20,7,13,14,3,0
15:00,Barnsley,Milton Keynes Dons,3,1,H,1,1,D,A Haines,20,2,6,2,10,8,7,2,3,4,0,0,30,40,2,4,22,8,9,18,7,0
15:00,Bristol Rvs,Peterboro,1,0,H,0,0,D,P Wright,19,9,5,1,5,16,9,2,1,0,0,1,10,25,0,1,28,6,11,21,1,1
15:00,Burton,Plymouth,2,2,D,1,0,H,M Woods,14,10,6,4,14,10,9,4,4,1,0,0,40,10,1,4,24,10,13,24,5,0
15:00,Cambridge,Accrington,0,1,A,0,1,A,C Pollard,5,12,1,2,16,12,1,7,1,2,0,0,10,20,1,1,17,3,8,28,3,0
15:00,Cheltenham,Wycombe,1,0,H,1,0,H,M Edwards,11,14,4,5,2,11,2,4,0,1,0,0,0,10,1,1,25,9,6,13,1,0
15:00,Fleetwood Town,Bolton,1,2,A,1,0,H,D Webb,12,18,2,6,15,12,2,6,3,3,0,0,30,30,1,3,30,8,8,27,6,0
15:00,Lincoln,Morecambe,2,1,H,1,0,H,M Coy,13,9,5,2,7,9,5,4,4,1,0,0,40,10,1,3,22,7,9,16,5,0
15:00,Oxford,Forest Green,1,1,D,1,0,H,S Mather,18,12,9,5,9,12,5,8,1,6,0,0,10,60,1,2,30,14,13,21,7,0
15:00,Port Vale,Charlton,1,0,H,0,0,D,S Barrott,13,5,1,1,11,9,2,7,1,3,0,0,10,30,0,1,18,2,9,20,4,0
15:00,Sheffield Weds,Shrewsbury,1,0,H,1,0,H,A Woolmer,14,9,4,1,9,12,7,1,1,1,0,0,10,10,1,1,23,5,8,21,2,0
19:45,Bolton,Bristol Rvs,1,1,D,0,1,A,R Lewis,19,2,5,1,12,17,11,1,1,3,0,0,10,30,1,2,21,6,12,29,4,0
19:45,Charlton,Cheltenham,0,1,A,0,0,D,A Young,14,13,4,5,7,8,11,4,0,2,0,0,0,20,0,1,27,9,15,15,2,0
19:45,Ipswich,Fleetwood Town,1,1,D,1,0,H,S Purkiss,12,7,6,3,9,10,5,2,1,2,0,1,10,45,1,2,19,9,7,19,3,1
19:45,Morecambe,Exeter,1,1,D,1,1,D,P Wright,7,19,1,7,4,12,6,15,2,0,0,0,20,0,2,2,26,8,21,16,2,0
19:45,Peterboro,Barnsley,1,2,A,1,1,D,S Allison,6,4,1,3,10,11,3,2,0,2,0,0,0,20,2,3,10,4,5,21,2,0
19:45,Plymouth,Port Vale,0,2,A,0,0,D,J Busby,15,12,6,7,9,10,4,3,1,2,0,0,10,20,0,2,27,13,7,19,3,0
12:30,Derby,Sheffield Weds,0,0,D,0,0,D,D Whitestone,7,5,3,2,10,5,4,2,2,0,0,0,20,0,0,0,12,5,6,15,2,0
12:30,Milton Keynes Dons,Burton,1,1,D,0,1,A,L Swabey,18,8,3,3,7,13,11,2,1,2,0,0,10,20,1,2,26,6,13,20,3,0
12:30,Shrewsbury,Lincoln,2,0,H,1,0,H,B Madden,10,13,4,3,12,8,5,5,2,3,0,0,20,30,1,2,23,7,10,20,5,0
13:00,Forest Green,Cambridge,2,1,H,1,0,H,J Oldham,12,8,4,3,11,12,5,6,3,1,1,0,55,10,1,3,20,7,11,23,4,1
15:00,Accrington,Oxford,1,1,D,0,0,D,S Barrott,12,7,4,1,11,14,5,2,4,2,0,0,40,20,0,2,19,5,7,25,6,0
12:30,Wycombe,Portsmouth,2,0,H,1,0,H,S Oldham,14,10,5,3,12,14,7,10,1,2,0,0,10,20,1,2,24,8,17,26,3,0
12:30,Ipswich,Peterboro,2,1,H,1,1,D,O Yates,11,8,4,3,13,5,4,6,3,0,0,0,30,0,2,3,19,7,10,18,3,0
12:30,Shrewsbury,Bolton,3,2,H,1,1,D,C Hicks,8,9,6,3,14,11,6,2,4,1,0,0,40,10,2,5,17,9,8,25,5,0
14:00,Burton,Derby,1,1,D,0,1,A,G Eltringham,11,14,4,4,11,9,10,3,0,2,0,0,0,20,1,2,25,8,13,20,2,0
14:00,Forest Green,Cheltenham,1,0,H,0,0,D,T Reeves,14,6,5,1,13,16,6,3,0,3,0,0,0,30,0,1,20,6,9,29,3,0
15:00,Bristol Rvs,Port Vale,1,0,H,0,0,D,C Brook,10,7,4,2,10,16,6,4,1,2,0,0,10,20,0,1,17,6,10,26,3,0
15:00,Cambridge,Plymouth,0,0,D,0,0,D,S Gill,13,14,4,1,7,17,5,7,0,5,0,0,0,50,0,0,27,5,12,24,5,0
15:00,Exeter,Sheffield Weds,1,1,D,0,0,D,N Hair,7,12,5,4,14,8,5,5,4,1,0,0,40,10,0,2,19,9,10,22,5,0
15:00,Lincoln,Wycombe,0,0,D,0,0,D,T Kirk,11,5,1,1,10,10,4,8,0,0,0,0,0,0,0,0,16,2,12,20,0,0
15:00,Milton Keynes Dons,Fleetwood Town,1,2,A,0,0,D,M Coy,17,7,6,2,10,15,7,2,1,1,0,0,10,10,0,3,24,8,9,25,2,0
15:00,Barnsley,Burton,2,0,H,1,0,H,A Young,11,8,4,3,9,9,3,6,1,1,0,0,10,10,1,2,19,7,9,18,2,0
15:00,Bolton,Exeter,2,0,H,2,0,H,S Oldham,11,5,3,2,8,11,4,5,0,1,0,0,0,10,2,2,16,5,9,19,1,0
15:00,Charlton,Bristol Rvs,1,2,A,1,0,H,S Allison,13,11,5,5,11,11,9,3,0,2,0,0,0,20,1,3,24,10,12,22,2,0
15:00,Derby,Forest Green,4,0,H,2,0,H,R Joyce,15,3,8,1,11,11,4,2,3,0,0,0,30,0,2,4,18,9,6,22,3,0
15:00,Plymouth,Morecambe,2,1,H,0,0,D,T Reeves,32,8,13,5,6,13,7,2,0,1,0,0,0,10,0,3,40,18,9,19,1,0
15:00,Portsmouth,Milton Keynes Dons,0,2,A,0,1,A,S Barrott,14,14,8,4,12,8,6,2,3,1,0,0,30,10,1,2,28,12,8,20,4,0
15:00,Sheffield Weds,Oxford,0,0,D,0,0,D,S Stockbridge,15,13,2,5,15,10,4,2,3,1,0,0,30,10,0,0,28,7,6,25,4,0
15:00,Wycombe,Ipswich,1,0,H,1,0,H,B Toner,9,19,3,6,13,10,2,7,4,0,0,0,40,0,1,1,28,9,9,23,4,0
15:00,Accrington,Barnsley,1,1,D,0,1,A,R Welch,4,20,2,5,11,16,4,16,2,3,0,0,20,30,1,2,24,7,20,27,5,0
15:00,Burton,Lincoln,3,0,H,3,0,H,B Toner,11,8,5,2,13,8,8,1,0,1,0,0,0,10,3,3,19,7,9,21,1,0
15:00,Cambridge,Shrewsbury,2,1,H,0,0,D,S Allison,9,13,2,5,13,9,4,5,3,2,0,1,30,45,0,3,22,7,9,22,5,1
15:00,Charlton,Peterboro,1,1,D,0,0,D,D Drysdale,8,19,3,6,14,10,3,10,1,0,0,0,10,0,0,2,27,9,13,24,1,0
15:00,Cheltenham,Plymouth,0,1,A,0,0,D,T Nield,16,13,6,3,7,10,6,4,1,1,0,0,10,10,0,1,29,9,10,17,2,0
15:00,Exeter,Portsmouth,0,0,D,0,0,D,A Young,14,15,3,5,16,13,4,14,3,3,0,0,30,30,0,0,29,8,18,29,6,0
15:00,Fleetwood Town,Sheffield Weds,1,2,A,1,1,D,D Handley,10,19,4,4,8,11,3,8,1,2,1,0,35,20,2,3,29,8,11,19,3,1
15:00,Ipswich,Oxford,3,0,H,2,0,H,W Finnie,18,7,9,2,7,8,13,4,1,2,0,0,10,20,2,3,25,11,17,15,3,0
15:00,Milton Keynes Dons,Forest Green,1,0,H,0,0,D,L Smith,14,14,5,5,15,15,6,7,4,2,0,0,40,20,0,1,28,10,13,30,6,0
15:00,Port Vale,Morecambe,1,0,H,1,0,H,S Mather,8,8,3,1,9,16,5,5,2,3,0,1,20,55,1,1,16,4,10,25,5,1
15:00,Wycombe,Bristol Rvs,2,1,H,1,1,D,S Gill,15,14,5,5,14,13,3,7,3,2,0,0,30,20,2,3,29,10,10,27,5,0
15:00,Bolton,Derby,0,0,D,0,0,D,S Barrott,9,11,2,2,9,8,2,4,2,1,0,0,20,10,0,0,20,4,6,17,3,0
19:45,Barnsley,Fleetwood Town,2,1,H,0,0,D,B Speedie,12,3,5,1,16,11,2,3,5,1,0,0,50,10,0,3,15,6,5,27,6,0
19:45,Bristol Rvs,Exeter,3,4,A,0,2,A,S Mather,12,14,6,8,9,20,3,8,1,6,0,0,10,60,2,7,26,14,11,29,7,0
19:45,Forest Green,Burton,1,2,A,0,1,A,T Kirk,8,7,2,3,9,16,6,7,1,3,0,0,10,30,1,3,15,5,13,25,4,0
19:45,Morecambe,Accrington,2,0,H,2,0,H,S Stockbridge,9,21,4,8,18,14,3,8,1,2,0,0,10,20,2,2,30,12,11,32,3,0
19:45,Oxford,Charlton,3,1,H,2,0,H,B Toner,16,10,5,3,16,14,4,3,0,3,0,0,0,30,2,4,26,8,7,30,3,0
19:45,Peterboro,Milton Keynes Dons,2,0,H,1,0,H,D Rock,16,5,6,2,12,11,7,2,3,2,0,0,30,20,1,2,21,8,9,23,5,0
19:45,Plymouth,Wycombe,1,0,H,1,0,H,C Brook,16,15,3,1,12,11,11,3,1,2,0,0,10,20,1,1,31,4,14,23,3,0
19:45,Portsmouth,Ipswich,2,2,D,1,1,D,S Allison,7,14,2,5,13,13,3,3,1,1,0,0,10,10,2,4,21,7,6,26,2,0
19:45,Sheffield Weds,Port Vale,2,0,H,1,0,H,D Drysdale,8,8,2,1,10,11,3,3,1,2,0,0,10,20,1,2,16,3,6,21,3,0
19:45,Shrewsbury,Cheltenham,0,1,A,0,1,A,S Purkiss,13,3,1,1,10,12,1,4,1,4,1,1,35,65,1,1,16,2,5,22,5,2
19:45,Derby,Cambridge,1,0,H,0,0,D,W Finnie,14,9,6,2,13,11,2,4,2,3,0,0,20,30,0,1,23,8,6,24,5,0
19:45,Lincoln,Bolton,1,1,D,1,0,H,G Eltringham,5,6,3,1,14,12,2,4,4,1,1,0,65,10,1,2,11,4,6,26,5,1
15:00,Bristol Rvs,Cheltenham,2,1,H,2,0,H,O Yates,10,20,3,4,9,11,5,6,1,1,0,0,10,10,2,3,30,7,11,20,2,0
15:00,Forest Green,Port Vale,1,3,A,1,0,H,L Swabey,10,18,1,4,12,14,2,8,3,3,0,0,30,30,1,4,28,5,10,26,6,0
15:00,Morecambe,Burton,5,0,H,2,0,H,A Backhouse,18,7,11,0,12,8,8,2,1,1,0,0,10,10,2,5,25,11,10,20,2,0
15:00,Oxford,Exeter,0,1,A,0,0,D,D Drysdale,20,9,5,4,4,15,11,4,1,4,0,0,10,40,0,1,29,9,15,19,5,0
15:00,Peterboro,Wycombe,0,3,A,0,1,A,S Barrott,25,13,7,7,8,2,8,3,0,0,0,0,0,0,1,3,38,14,11,10,0,0
15:00,Plymouth,Milton Keynes Dons,3,1,H,2,1,H,P Howard,10,10,6,4,10,9,1,3,0,1,0,0,0,10,3,4,20,10,4,19,1,0
15:00,Portsmouth,Charlton,1,3,A,1,1,D,T Reeves,11,14,4,4,15,7,7,6,1,2,1,0,35,20,2,4,25,8,13,22,3,1
15:00,Shrewsbury,Fleetwood Town,0,3,A,0,2,A,R Joyce,6,15,0,4,15,11,8,3,1,1,1,0,35,10,2,3,21,4,11,26,2,1
15:00,Barnsley,Bolton,0,3,A,0,2,A,S Stockbridge,9,14,3,3,12,11,3,8,0,2,1,0,25,20,2,3,23,6,11,23,2,1
15:00,Derby,Accrington,4,0,H,3,0,H,M Woods,15,5,6,3,14,12,6,5,3,3,1,0,55,30,3,4,20,9,11,26,6,1
15:00,Lincoln,Ipswich,1,1,D,0,0,D,D Bourne,2,21,1,8,9,12,3,9,2,1,1,0,45,10,0,2,23,9,12,21,3,1
15:00,Sheffield Weds,Cambridge,5,0,H,2,0,H,A Haines,25,10,8,2,11,5,6,3,0,1,0,0,0,10,2,5,35,10,9,16,1,0
15:00,Bolton,Plymouth,0,0,D,0,0,D,D Bourne,14,6,2,2,9,10,7,4,1,2,0,1,10,45,0,0,20,4,11,19,3,1
15:00,Cambridge,Bristol Rvs,1,2,A,1,2,A,T Parsons,12,4,2,4,10,14,9,3,3,4,0,0,30,40,3,3,16,6,12,24,7,0
15:00,Charlton,Lincoln,2,1,H,2,0,H,J Oldham,19,11,7,2,15,11,0,1,3,1,0,0,30,10,2,3,30,9,1,26,4,0
15:00,Morecambe,Cheltenham,2,1,H,1,1,D,M Woods,9,12,5,1,12,13,5,6,2,1,0,0,20,10,2,3,21,6,11,25,3,0
15:00,Accrington,Bristol Rvs,2,0,H,0,0,D,T Nield,9,8,2,4,11,14,4,2,4,2,0,0,40,20,0,2,17,6,6,25,6,0
15:00,Bolton,Portsmouth,3,0,H,1,0,H,G Eltringham,13,13,8,3,8,12,4,3,0,1,0,0,0,10,1,3,26,11,7,20,1,0
15:00,Burton,Shrewsbury,0,4,A,0,2,A,S Stockbridge,9,11,1,7,8,10,9,2,0,3,0,0,0,30,2,4,20,8,11,18,3,0
15:00,Charlton,Barnsley,2,0,H,1,0,H,C Hicks,8,23,4,2,17,13,0,11,3,5,0,0,30,50,1,2,31,6,11,30,8,0
15:00,Cheltenham,Derby,2,3,A,1,2,A,N Hair,14,14,5,5,10,6,3,3,2,2,0,0,20,20,3,5,28,10,6,16,4,0
15:00,Exeter,Forest Green,1,1,D,0,0,D,D Rock,12,6,2,1,11,7,10,3,2,1,0,0,20,10,0,2,18,3,13,18,3,0
15:00,Fleetwood Town,Oxford,1,2,A,1,0,H,J Oldham,19,11,7,2,15,12,10,3,1,3,0,0,10,30,1,3,30,9,13,27,4,0
15:00,Ipswich,Plymouth,1,1,D,0,0,D,A Woolmer,12,9,5,5,9,10,4,2,2,1,0,0,20,10,0,2,21,10,6,19,3,0
15:00,Milton Keynes Dons,Lincoln,0,0,D,0,0,D,B Speedie,5,6,1,2,12,12,5,5,1,1,0,0,10,10,0,0,11,3,10,24,2,0
15:00,Wycombe,Sheffield Weds,0,1,A,0,1,A,S Allison,8,12,2,4,9,15,4,3,1,1,0,0,10,10,1,1,20,6,7,24,2,0
20:00,Port Vale,Peterboro,0,2,A,0,0,D,P Wright,11,14,4,3,6,11,1,5,0,1,0,0,0,10,0,2,25,7,6,17,1,0
15:00,Barnsley,Accrington,3,1,H,3,0,H,C Brook,14,9,5,2,14,13,8,2,1,2,0,0,10,20,3,4,23,7,10,27,3,0
15:00,Derby,Bolton,2,1,H,1,0,H,J Simpson,8,6,5,3,8,10,5,4,1,1,0,0,10,10,1,3,14,8,9,18,2,0
15:00,Forest Green,Milton Keynes Dons,1,2,A,1,1,D,A Backhouse,6,6,2,2,9,9,3,3,2,4,0,0,20,40,2,3,12,4,6,18,6,0
15:00,Oxford,Ipswich,2,1,H,1,1,D,B Madden,13,17,5,6,9,22,3,5,0,1,0,0,0,10,2,3,30,11,8,31,1,0
15:00,Plymouth,Cheltenham,4,2,H,2,1,H,S Martin,15,9,6,4,9,12,6,5,0,1,0,0,0,10,3,6,24,10,11,21,1,0
15:00,Portsmouth,Exeter,2,0,H,0,0,D,O Yates,14,12,4,3,12,8,7,10,1,2,0,0,10,20,0,2,26,7,17,20,3,0
15:00,Sheffield Weds,Fleetwood Town,1,0,H,1,0,H,S Mather,14,9,4,2,15,15,4,2,1,2,0,0,10,20,1,1,23,6,6,30,3,0
15:00,Shrewsbury,Cambridge,5,1,H,2,0,H,T Kirk,19,10,8,2,10,11,7,5,0,4,0,0,0,40,2,6,29,10,12,21,4,0
19:45,Bolton,Forest Green,1,0,H,1,0,H,T Nield,4,12,2,4,6,7,1,1,1,1,1,0,35,10,1,1,16,6,2,13,2,1
19:45,Fleetwood Town,Portsmouth,0,2,A,0,1,A,A Backhouse,14,15,3,7,12,13,4,7,2,3,0,1,20,55,1,2,29,10,11,25,5,1
19:45,Ipswich,Morecambe,4,0,H,4,0,H,D Rock,19,4,9,0,13,11,6,1,1,2,0,0,10,20,4,4,23,9,7,24,3,0
19:45,Milton Keynes Dons,Shrewsbury,0,1,A,0,0,D,A Young,13,7,1,2,7,13,6,3,1,3,0,0,10,30,0,1,20,3,9,20,4,0
19:45,Port Vale,Derby,1,2,A,0,0,D,B Toner,15,16,7,8,7,11,7,9,1,1,0,0,10,10,0,3,31,15,16,18,2,0
19:45,Wycombe,Oxford,2,0,H,2,0,H,N Hair,11,19,5,2,15,9,2,11,2,1,0,0,20,10,2,2,30,7,13,24,3,0
12:30,Charlton,Bolton,1,2,A,0,1,A,C Brook,12,24,5,8,11,13,6,3,1,3,0,0,10,30,1,3,36,13,9,24,4,0
15:00,Burton,Oxford,2,0,H,1,0,H,A Herczeg,14,13,5,3,9,13,5,8,0,1,0,0,0,10,1,2,27,8,13,22,1,0
15:00,Cheltenham,Port Vale,0,0,D,0,0,D,M Coy,12,14,3,4,9,9,4,6,0,0,0,0,0,0,0,0,26,7,10,18,0,0
15:00,Lincoln,Cambridge,0,0,D,0,0,D,P Wright,11,12,2,3,9,10,4,3,3,3,0,0,30,30,0,0,23,5,7,19,6,0
15:00,Milton Keynes Dons,Exeter,0,2,A,0,1,A,A Haines,15,4,2,2,7,16,5,2,4,1,0,0,40,10,1,2,19,4,7,23,5,0
15:00,Morecambe,Bristol Rvs,5,1,H,1,0,H,W Finnie,14,18,5,7,9,9,3,8,2,2,0,0,20,20,1,6,32,12,11,18,4,0
15:00,Peterboro,Portsmouth,2,1,H,2,0,H,R Madley,14,8,5,1,14,13,8,2,2,2,0,0,20,20,2,3,22,6,10,27,4,0
15:00,Shrewsbury,Forest Green,2,1,H,0,1,A,A Kitchen,11,13,5,2,6,11,7,5,2,2,0,0,20,20,1,3,24,7,12,17,4,0
19:45,Oxford,Barnsley,1,2,A,0,1,A,L Swabey,16,9,2,5,12,11,10,5,0,4,0,0,0,40,1,3,25,7,15,23,4,0
15:00,Accrington,Lincoln,0,3,A,0,1,A,S Purkiss,6,21,2,11,12,16,1,0,2,2,1,0,45,20,1,3,27,13,1,28,4,1
15:00,Bolton,Cheltenham,1,0,H,0,0,D,S Gill,14,10,2,3,7,12,7,6,1,3,0,0,10,30,0,1,24,5,13,19,4,0
15:00,Bristol Rvs,Milton Keynes Dons,0,2,A,0,1,A,C Boyeson,6,11,1,4,11,17,3,5,2,5,0,0,20,50,1,2,17,5,8,28,7,0
15:00,Cambridge,Ipswich,1,1,D,1,0,H,S Barrott,6,14,2,4,6,11,4,8,2,2,0,0,20,20,1,2,20,6,12,17,4,0
15:00,Derby,Morecambe,5,0,H,1,0,H,C Hicks,26,4,12,0,6,17,8,3,0,4,0,0,0,40,1,5,30,12,11,23,4,0
15:00,Exeter,Charlton,1,2,A,1,2,A,D Bourne,13,9,5,4,8,15,14,3,2,2,0,0,20,20,3,3,22,9,17,23,4,0
15:00,Fleetwood Town,Burton,2,3,A,0,0,D,M Coy,16,16,3,6,9,8,5,3,0,1,0,0,0,10,0,5,32,9,8,17,1,0
15:00,Forest Green,Peterboro,0,2,A,0,0,D,B Toner,6,11,2,4,18,13,6,3,4,2,0,0,40,20,0,2,17,6,9,31,6,0
15:00,Oxford,Shrewsbury,0,1,A,0,0,D,S Oldham,16,7,6,4,13,17,8,1,2,3,0,0,20,30,0,1,23,10,9,30,5,0
15:00,Port Vale,Wycombe,0,3,A,0,1,A,M Edwards,12,13,0,4,13,13,5,7,1,3,0,0,10,30,1,3,25,4,12,26,4,0
15:00,Portsmouth,Barnsley,1,1,D,0,0,D,A Woolmer,14,12,3,2,16,16,8,5,0,1,0,0,0,10,0,2,26,5,13,32,1,0
15:00,Sheffield Weds,Plymouth,1,0,H,1,0,H,J Busby,11,9,4,1,18,9,5,3,3,1,0,0,30,10,1,1,20,5,8,27,4,0
19:45,Port Vale,Accrington,1,1,D,0,0,D,B Speedie,15,5,6,2,21,7,4,3,4,2,0,1,40,45,0,2,20,8,7,28,6,1
15:00,Barnsley,Cambridge,2,0,H,1,0,H,R Joyce,7,9,4,3,16,11,3,5,1,4,1,0,35,40,1,2,16,7,8,27,5,1
15:00,Burton,Exeter,1,0,H,0,0,D,C Brook,9,16,2,3,8,12,3,10,1,1,0,0,10,10,0,1,25,5,13,20,2,0
15:00,Charlton,Fleetwood Town,1,2,A,1,1,D,C Boyeson,12,12,3,6,10,15,2,3,2,5,1,0,45,50,2,3,24,9,5,25,7,1
15:00,Cheltenham,Accrington,0,0,D,0,0,D,W Finnie,14,9,5,2,15,14,5,2,3,3,0,0,30,30,0,0,23,7,7,29,6,0
15:00,Ipswich,Sheffield Weds,2,2,D,1,2,A,G Eltringham,12,8,6,3,12,14,6,2,0,2,0,0,0,20,3,4,20,9,8,26,2,0
15:00,Lincoln,Bristol Rvs,1,0,H,1,0,H,T Reeves,20,11,9,4,12,13,5,4,0,3,0,1,0,55,1,1,31,13,9,25,3,1
15:00,Milton Keynes Dons,Oxford,1,1,D,1,0,H,A Kitchen,9,15,3,5,6,10,1,6,1,2,0,0,10,20,1,2,24,8,7,16,3,0
15:00,Morecambe,Forest Green,1,1,D,0,0,D,M Coy,6,9,4,4,10,12,4,7,0,2,0,0,0,20,0,2,15,8,11,22,2,0
15:00,Peterboro,Bolton,0,5,A,0,2,A,L Swabey,16,14,6,7,13,16,8,3,3,3,0,0,30,30,2,5,30,13,11,29,6,0
15:00,Plymouth,Portsmouth,3,1,H,1,0,H,S Mather,20,23,9,4,15,9,4,7,2,2,0,0,20,20,1,4,43,13,11,24,4,0
15:00,Shrewsbury,Port Vale,3,2,H,3,1,H,T Parsons,10,17,6,6,12,16,7,2,3,4,0,0,30,40,4,5,27,12,9,28,7,0
15:00,Wycombe,Derby,3,2,H,1,0,H,R Lewis,14,13,7,6,12,11,5,6,3,2,0,0,30,20,1,5,27,13,11,23,5,0
19:45,Accrington,Wycombe,0,2,A,0,1,A,L Smith,22,14,5,5,6,13,7,5,2,1,0,0,20,10,1,2,36,10,12,19,3,0
19:45,Bolton,Milton Keynes Dons,5,0,H,3,0,H,M Edwards,18,10,11,2,10,7,5,4,0,0,0,0,0,0,3,5,28,13,9,17,0,0
19:45,Bristol Rvs,Ipswich,0,0,D,0,0,D,P Howard,9,21,4,7,6,11,6,10,0,1,0,0,0,10,0,0,30,11,16,17,1,0
19:45,Cambridge,Cheltenham,1,2,A,0,0,D,A Woolmer,10,12,4,3,8,14,4,2,1,3,0,0,10,30,0,3,22,7,6,22,4,0
19:45,Derby,Lincoln,1,1,D,0,1,A,S Oldham,21,9,7,5,8,7,5,2,1,1,0,1,10,35,1,2,30,12,7,15,2,1
19:45,Exeter,Shrewsbury,0,0,D,0,0,D,B Speedie,9,10,3,1,7,8,5,3,0,1,0,0,0,10,0,0,19,4,8,15,1,0
19:45,Fleetwood Town,Peterboro,1,0,H,1,0,H,M Woods,5,14,1,3,17,9,1,7,2,2,0,0,20,20,1,1,19,4,8,26,4,0
19:45,Forest Green,Charlton,0,1,A,0,1,A,C Pollard,13,7,1,3,10,8,9,3,0,1,0,0,0,10,1,1,20,4,12,18,1,0
19:45,Oxford,Plymouth,1,3,A,1,1,D,A Young,9,14,4,6,17,14,6,8,3,5,0,0,30,50,2,4,23,10,14,31,8,0
19:45,Port Vale,Barnsley,1,3,A,1,2,A,S Barrott,15,7,2,4,9,9,10,3,0,2,0,0,0,20,3,4,22,6,13,18,2,0
19:45,Portsmouth,Burton,1,0,H,0,0,D,T Robinson,16,4,7,2,5,22,4,3,0,4,0,0,0,40,0,1,20,9,7,27,4,0
19:45,Sheffield Weds,Morecambe,3,0,H,2,0,H,R Lewis,17,6,5,2,7,7,3,1,1,2,0,0,10,20,2,3,23,7,4,14,3,0
15:00,Accrington,Shrewsbury,1,0,H,1,0,H,A Backhouse,6,12,1,2,11,13,1,7,3,3,0,0,30,30,1,1,18,3,8,24,6,0
15:00,Bristol Rvs,Burton,1,2,A,1,1,D,C Pollard,10,18,2,10,11,16,8,5,0,3,0,0,0,30,2,3,28,12,13,27,3,0
15:00,Cambridge,Oxford,1,0,H,1,0,H,O Yates,7,10,3,3,14,12,6,8,3,1,0,0,30,10,1,1,17,6,14,26,4,0
15:00,Cheltenham,Barnsley,0,4,A,0,3,A,D Bourne,8,9,1,5,8,11,5,5,0,0,0,0,0,0,3,4,17,6,10,19,0,0
15:00,Derby,Charlton,2,0,H,1,0,H,P Howard,20,8,8,2,11,13,9,2,1,3,0,0,10,30,1,2,28,10,11,24,4,0
15:00,Ipswich,Forest Green,4,0,H,2,0,H,C Brook,25,4,12,0,11,5,10,3,0,2,0,0,0,20,2,4,29,12,13,16,2,0
15:00,Lincoln,Portsmouth,0,0,D,0,0,D,R Joyce,15,14,2,5,13,8,9,4,2,4,0,0,20,40,0,0,29,7,13,21,6,0
15:00,Morecambe,Peterboro,0,3,A,0,3,A,D Handley,12,12,1,6,10,13,8,6,1,1,0,0,10,10,3,3,24,7,14,23,2,0
15:00,Plymouth,Fleetwood Town,0,0,D,0,0,D,D Rock,17,7,2,0,3,16,5,4,1,6,0,0,10,60,0,0,24,2,9,19,7,0
15:00,Port Vale,Exeter,1,0,H,0,0,D,A Kitchen,13,6,5,0,11,8,5,3,3,1,0,1,30,35,0,1,19,5,8,19,4,1
15:00,Sheffield Weds,Milton Keynes Dons,5,2,H,1,2,A,S Oldham,22,6,8,2,8,6,10,2,0,1,0,0,0,10,3,7,28,10,12,14,1,0
15:00,Wycombe,Bolton,1,0,H,1,0,H,A Woolmer,19,16,6,3,9,9,7,7,2,2,0,0,20,20,1,1,35,9,14,18,4,0
19:45,Fleetwood Town,Cambridge,1,0,H,0,0,D,D Bourne,9,10,1,3,13,6,5,4,3,1,0,0,30,10,0,1,19,4,9,19,4,0
19:45,Morecambe,Port Vale,1,0,H,0,0,D,R Joyce,9,13,2,3,13,10,2,3,1,1,0,0,10,10,0,1,22,5,5,23,2,0
12:30,Oxford,Bristol Rvs,0,3,A,0,2,A,C Breakspear,14,5,2,4,16,11,6,5,2,2,0,0,20,20,2,3,19,6,11,27,4,0
15:00,Barnsley,Derby,4,1,H,3,1,H,B Madden,10,10,5,5,13,7,6,4,3,0,0,0,30,0,4,5,20,10,10,20,3,0
15:00,Bolton,Port Vale,2,1,H,2,1,H,W Finnie,5,12,2,5,13,8,4,10,0,0,0,0,0,0,3,3,17,7,14,21,0,0
15:00,Burton,Accrington,0,0,D,0,0,D,J Smith,11,7,2,1,8,7,6,5,1,2,0,0,10,20,0,0,18,3,11,15,3,0
15:00,Charlton,Sheffield Weds,0,1,A,0,1,A,B Speedie,7,17,3,4,12,14,1,8,1,3,0,0,10,30,1,1,24,7,9,26,4,0
15:00,Exeter,Cambridge,2,0,H,1,0,H,R Lewis,16,5,6,1,13,5,9,1,0,0,0,0,0,0,1,2,21,7,10,18,0,0
15:00,Fleetwood Town,Morecambe,1,0,H,1,0,H,A Davies,8,8,3,1,9,6,5,7,2,3,0,0,20,30,1,1,16,4,12,15,5,0
15:00,Forest Green,Lincoln,1,1,D,0,1,A,C Hicks,9,13,5,3,15,11,2,9,3,2,0,0,30,20,1,2,22,8,11,26,5,0
15:00,Milton Keynes Dons,Ipswich,0,1,A,0,1,A,R Welch,9,21,3,8,7,14,4,7,2,2,0,0,20,20,1,1,30,11,11,21,4,0
15:00,Peterboro,Plymouth,5,2,H,2,1,H,S Oldham,19,13,12,7,11,11,4,8,1,2,0,0,10,20,3,7,32,19,12,22,3,0
15:00,Portsmouth,Cheltenham,4,0,H,3,0,H,L Swabey,13,9,6,1,13,16,3,3,1,5,0,0,10,50,3,4,22,7,6,29,6,0
15:00,Shrewsbury,Wycombe,2,0,H,1,0,H,C Brook,8,15,2,4,14,8,7,5,4,0,0,0,40,0,1,2,23,6,12,22,4,0
19:45,Derby,Cheltenham,2,0,H,1,0,H,R Welch,12,5,3,0,12,9,3,2,2,3,0,0,20,30,1,2,17,3,5,21,5,0
19:45,Lincoln,Milton Keynes Dons,1,1,D,1,0,H,S Stockbridge,9,6,2,4,13,7,5,3,1,2,0,0,10,20,1,2,15,6,8,20,3,0
19:45,Peterboro,Charlton,0,0,D,0,0,D,A Kitchen,7,15,2,2,8,10,5,8,1,2,1,0,35,20,0,0,22,4,13,18,3,1
19:45,Portsmouth,Bolton,3,1,H,0,0,D,S Martin,17,10,5,2,16,19,6,2,2,4,0,0,20,40,0,4,27,7,8,35,6,0
12:30,Morecambe,Bolton,0,0,D,0,0,D,O Langford,11,13,2,4,12,7,2,11,1,0,0,0,10,0,0,0,24,6,13,19,1,0
15:00,Accrington,Forest Green,2,1,H,1,1,D,D Bourne,17,6,4,3,9,16,3,3,1,3,0,1,10,55,2,3,23,7,6,25,4,1
15:00,Bristol Rvs,Barnsley,0,0,D,0,0,D,T Parsons,7,10,2,3,8,14,3,7,3,2,0,0,30,20,0,0,17,5,10,22,5,0
15:00,Cambridge,Portsmouth,0,1,A,0,0,D,A Kitchen,17,5,4,3,10,9,7,3,1,1,0,0,10,10,0,1,22,7,10,19,2,0
15:00,Cheltenham,Fleetwood Town,1,0,H,0,0,D,S Allison,18,10,4,0,4,10,5,5,1,3,0,0,10,30,0,1,28,4,10,14,4,0
15:00,Derby,Shrewsbury,2,2,D,2,0,H,S Mather,18,6,4,5,11,5,3,3,3,2,0,0,30,20,2,4,24,9,6,16,5,0
15:00,Ipswich,Burton,4,0,H,3,0,H,C Boyeson,17,14,7,2,5,13,3,8,1,4,0,0,10,40,3,4,31,9,11,18,5,0
15:00,Lincoln,Oxford,1,0,H,1,0,H,L Smith,8,16,4,5,8,11,1,15,0,2,0,0,0,20,1,1,24,9,16,19,2,0
15:00,Plymouth,Charlton,2,0,H,0,0,D,A Woolmer,19,8,6,0,11,17,14,3,0,0,0,0,0,0,0,2,27,6,17,28,0,0
15:00,Port Vale,Milton Keynes Dons,1,0,H,1,0,H,D Handley,13,9,2,1,13,14,5,4,3,3,0,0,30,30,1,1,22,3,9,27,6,0
15:00,Sheffield Weds,Peterboro,1,0,H,0,0,D,A Backhouse,12,3,3,0,18,9,7,0,3,1,0,0,30,10,0,1,15,3,7,27,4,0
15:00,Wycombe,Exeter,1,1,D,1,0,H,T Nield,9,16,1,4,8,12,2,3,0,3,0,0,0,30,1,2,25,5,5,20,3,0
19:45,Barnsley,Portsmouth,3,1,H,2,0,H,M Edwards,18,6,7,3,11,6,4,2,1,0,0,0,10,0,2,4,24,10,6,17,1,0
19:45,Cambridge,Morecambe,1,1,D,1,1,D,P Howard,24,10,8,4,6,9,9,1,2,0,0,0,20,0,2,2,34,12,10,15,2,0
19:45,Cheltenham,Lincoln,0,0,D,0,0,D,D Handley,5,11,1,0,10,5,6,4,2,1,0,0,20,10,0,0,16,1,10,15,3,0
19:45,Ipswich,Accrington,3,0,H,1,0,H,L Swabey,18,5,8,3,9,7,6,3,1,1,0,1,10,35,1,3,23,11,9,16,2,1
19:45,Peterboro,Shrewsbury,2,1,H,1,1,D,D Bourne,11,8,4,2,5,14,5,7,3,3,0,0,30,30,2,3,19,6,12,19,6,0
19:45,Wycombe,Fleetwood Town,2,0,H,1,0,H,C Hicks,22,11,5,4,9,12,7,4,0,1,0,0,0,10,1,2,33,9,11,21,1,0
20:00,Plymouth,Derby,2,1,H,0,1,A,C Breakspear,10,10,5,4,7,15,4,4,2,1,0,0,20,10,1,3,20,9,8,22,3,0
15:00,Barnsley,Plymouth,3,0,H,0,0,D,W Finnie,12,8,5,3,6,10,3,2,1,2,0,0,10,20,0,3,20,8,5,16,3,0
15:00,Bolton,Ipswich,0,2,A,0,1,A,N Hair,6,18,3,6,9,9,6,8,2,5,0,0,20,50,1,2,24,9,14,18,7,0
15:00,Burton,Wycombe,2,1,H,2,0,H,L Swabey,10,21,4,4,12,13,4,5,1,2,1,0,35,20,2,3,31,8,9,25,3,1
15:00,Charlton,Accrington,1,1,D,1,1,D,D Drysdale,10,16,3,8,10,11,3,7,2,3,0,0,20,30,2,2,26,11,10,21,5,0
15:00,Exeter,Lincoln,2,1,H,1,1,D,S Gill,8,7,2,3,14,7,4,7,3,2,1,0,55,20,2,3,15,5,11,21,5,1
15:00,Fleetwood Town,Port Vale,1,1,D,0,0,D,P Howard,12,17,5,3,9,14,2,8,1,3,0,0,10,30,0,2,29,8,10,23,4,0
15:00,Forest Green,Bristol Rvs,1,3,A,1,2,A,S Oldham,4,13,2,6,6,9,7,7,1,3,0,0,10,30,3,4,17,8,14,15,4,0
15:00,Milton Keynes Dons,Cambridge,1,0,H,1,0,H,K Stroud,12,6,2,3,9,14,6,3,0,4,0,0,0,40,1,1,18,5,9,23,4,0
15:00,Oxford,Derby,2,3,A,1,2,A,M Edwards,13,8,8,4,11,11,11,2,1,1,0,0,10,10,3,5,21,12,13,22,2,0
15:00,Peterboro,Cheltenham,0,3,A,0,2,A,A Young,14,10,1,6,8,9,3,3,3,2,0,0,30,20,2,3,24,7,6,17,5,0
15:00,Portsmouth,Sheffield Weds,0,1,A,0,1,A,B Toner,12,6,2,2,6,20,9,5,2,2,0,1,20,45,1,1,18,4,14,26,4,1
15:00,Shrewsbury,Morecambe,3,1,H,2,1,H,R Welch,21,10,8,2,8,12,8,3,3,0,0,0,30,0,3,4,31,10,11,20,3,0
19:45,Accrington,Portsmouth,1,3,A,0,1,A,D Rock,20,10,4,7,12,18,7,4,3,2,1,1,55,45,1,4,30,11,11,30,5,2
19:45,Bristol Rvs,Wycombe,0,2,A,0,1,A,R  Welch,21,15,6,8,18,8,6,3,1,2,0,0,10,20,1,2,36,14,9,26,3,0
19:45,Burton,Peterboro,2,5,A,1,3,A,C Hicks,17,13,11,8,7,11,4,4,1,0,0,0,10,0,4,7,30,19,8,18,1,0
19:45,Morecambe,Charlton,1,4,A,0,3,A,A Haines,11,20,2,10,9,12,5,4,1,2,0,0,10,20,3,5,31,12,9,21,3,0
19:45,Sheffield Weds,Bolton,1,1,D,1,1,D,S Purkiss,13,4,7,1,12,10,4,5,1,1,0,0,10,10,2,2,17,8,9,22,2,0
13:00,Lincoln,Peterboro,0,3,A,0,1,A,R Lewis,9,8,1,4,13,12,2,1,2,2,0,0,20,20,1,3,17,5,3,25,4,0
15:00,Accrington,Milton Keynes Dons,0,1,A,0,1,A,C Hicks,10,11,2,4,15,12,9,6,3,2,0,0,30,20,1,1,21,6,15,27,5,0
15:00,Bristol Rvs,Portsmouth,0,2,A,0,1,A,J Bell,17,7,7,3,10,13,4,3,2,2,1,0,45,20,1,2,24,10,7,23,4,1
15:00,Cambridge,Charlton,1,2,A,0,2,A,M Edwards,10,9,4,4,8,7,8,4,2,0,0,0,20,0,2,3,19,8,12,15,2,0
15:00,Cheltenham,Exeter,3,1,H,1,0,H,A Backhouse,10,12,6,5,12,8,1,6,5,2,0,0,50,20,1,4,22,11,7,20,7,0
15:00,Derby,Fleetwood Town,0,2,A,0,2,A,S Stockbridge,15,8,2,3,13,11,3,8,2,3,0,0,20,30,2,2,23,5,11,24,5,0
15:00,Ipswich,Shrewsbury,2,0,H,1,0,H,O Yates,22,6,4,3,11,12,5,4,1,5,0,0,10,50,1,2,28,7,9,23,6,0
15:00,Morecambe,Oxford,1,1,D,0,1,A,S Barrott,5,9,2,4,13,14,1,1,3,1,0,0,30,10,1,2,14,6,2,27,4,0
15:00,Plymouth,Forest Green,2,0,H,1,0,H,B Speedie,8,5,2,1,8,3,6,2,0,1,0,0,0,10,1,2,13,3,8,11,1,0
15:00,Port Vale,Burton,2,3,A,1,1,D,S Allison,10,14,5,4,9,12,3,3,2,3,0,0,20,30,2,5,24,9,6,21,5,0
15:00,Wycombe,Barnsley,0,1,A,0,0,D,C Breakspear,10,7,1,2,11,15,12,1,1,4,0,0,10,40,0,1,17,3,13,26,5,0
19:45,Accrington,Plymouth,0,2,A,0,1,A,J Bell,10,12,3,6,18,13,5,4,3,0,1,0,55,0,1,2,22,9,9,31,3,1
20:00,Barnsley,Sheffield Weds,4,2,H,2,1,H,R Joyce,12,18,6,6,11,14,1,6,5,3,0,0,50,30,3,6,30,12,7,25,8,0
15:00,Charlton,Wycombe,1,1,D,1,0,H,S Oldham,10,13,5,4,12,11,7,6,5,3,0,0,50,30,1,2,23,9,13,23,8,0
15:00,Exeter,Accrington,5,0,H,1,0,H,O Langford,18,4,11,0,11,10,4,0,1,1,0,0,10,10,1,5,22,11,4,21,2,0
15:00,Fleetwood Town,Lincoln,2,1,H,1,1,D,D Bourne,13,16,7,6,14,8,8,4,2,0,0,0,20,0,2,3,29,13,12,22,2,0
15:00,Milton Keynes Dons,Morecambe,1,0,H,0,0,D,T Parsons,15,10,6,1,7,15,3,7,1,3,0,0,10,30,0,1,25,7,10,22,4,0
15:00,Peterboro,Derby,2,0,H,0,0,D,C Brook,9,13,6,5,9,13,3,8,3,1,0,0,30,10,0,2,22,11,11,22,4,0
15:00,Portsmouth,Port Vale,2,2,D,0,2,A,N Hair,8,5,4,3,11,20,11,5,0,5,0,0,0,50,2,4,13,7,16,31,5,0
13:00,Forest Green,Sheffield Weds,1,0,H,1,0,H,D Rock,6,7,2,3,5,12,2,6,1,1,0,0,10,10,1,1,13,5,8,17,2,0
19:45,Exeter,Barnsley,3,1,H,1,1,D,D Handley,9,16,6,4,11,9,4,4,3,2,0,0,30,20,2,4,25,10,8,20,5,0
19:45,Cheltenham,Sheffield Weds,2,2,D,0,0,D,P Howard,15,21,8,5,6,12,2,11,2,1,0,0,20,10,0,4,36,13,13,18,3,0
15:00,Barnsley,Morecambe,5,0,H,3,0,H,S Stockbridge,17,9,10,2,12,11,5,6,1,0,0,0,10,0,3,5,26,12,11,23,1,0
15:00,Charlton,Shrewsbury,6,0,H,3,0,H,R Madley,17,11,11,1,10,13,5,5,2,3,0,1,20,55,3,6,28,12,10,23,5,1
15:00,Cheltenham,Burton,0,0,D,0,0,D,O Yates,20,6,4,3,8,7,7,3,3,0,0,0,30,0,0,0,26,7,10,15,3,0
15:00,Derby,Ipswich,0,2,A,0,1,A,A Backhouse,6,13,2,6,8,8,4,4,4,3,0,0,40,30,1,2,19,8,8,16,7,0
15:00,Fleetwood Town,Exeter,2,2,D,2,1,H,L Smith,14,11,3,4,12,7,5,5,1,0,0,0,10,0,3,4,25,7,10,19,1,0
15:00,Peterboro,Oxford,0,0,D,0,0,D,T Kirk,10,3,3,1,11,11,7,1,0,1,0,0,0,10,0,0,13,4,8,22,1,0
15:00,Port Vale,Cambridge,0,2,A,0,0,D,T Reeves,11,16,4,6,12,11,2,0,3,0,0,0,30,0,0,2,27,10,2,23,3,0
15:00,Portsmouth,Forest Green,1,0,H,0,0,D,P Howard,11,5,3,2,9,11,5,0,3,2,0,0,30,20,0,1,16,5,5,20,5,0
15:00,Sheffield Weds,Lincoln,1,1,D,1,1,D,B Madden,21,5,5,3,12,13,6,4,0,0,0,0,0,0,2,2,26,8,10,25,0,0
15:00,Wycombe,Milton Keynes Dons,2,2,D,1,1,D,S Purkiss,11,10,2,4,12,16,6,5,0,3,0,0,0,30,2,4,21,6,11,28,3,0
15:00,Accrington,Port Vale,3,0,H,2,0,H,A Woolmer,17,9,3,2,13,13,5,7,1,1,0,1,10,35,2,3,26,5,12,26,2,1
15:00,Bristol Rvs,Charlton,1,0,H,0,0,D,S Mather,10,6,3,1,5,10,5,8,0,0,0,0,0,0,0,1,16,4,13,15,0,0
15:00,Burton,Barnsley,2,1,H,0,0,D,A Herczeg,7,20,2,9,9,18,2,12,6,2,0,0,60,20,0,3,27,11,14,27,8,0
15:00,Cambridge,Fleetwood Town,2,1,H,1,0,H,L Swabey,13,10,7,7,9,17,2,3,4,4,0,0,40,40,1,3,23,14,5,26,8,0
15:00,Exeter,Bolton,0,1,A,0,1,A,C Hicks,11,6,3,2,9,18,8,3,0,3,0,0,0,30,1,1,17,5,11,27,3,0
15:00,Forest Green,Derby,0,2,A,0,1,A,W Finnie,3,14,1,7,8,14,1,6,1,1,0,0,10,10,1,2,17,8,7,22,2,0
15:00,Ipswich,Wycombe,4,0,H,2,0,H,D Rock,14,6,6,0,8,9,7,1,0,2,0,0,0,20,2,4,20,6,8,17,2,0
15:00,Lincoln,Cheltenham,2,0,H,1,0,H,A Kitchen,14,14,7,3,12,11,3,5,0,1,0,0,0,10,1,2,28,10,8,23,1,0
15:00,Milton Keynes Dons,Portsmouth,1,1,D,0,1,A,C Brook,15,5,3,2,11,17,11,2,0,4,0,1,0,65,1,2,20,5,13,28,4,1
15:00,Morecambe,Plymouth,1,3,A,1,0,H,M Edwards,6,11,3,6,16,9,8,9,2,2,0,0,20,20,1,4,17,9,17,25,4,0
15:00,Oxford,Sheffield Weds,1,1,D,0,1,A,R Welch,14,11,7,8,7,14,5,6,2,2,0,0,20,20,1,2,25,15,11,21,4,0
15:00,Shrewsbury,Peterboro,0,3,A,0,1,A,C Boyeson,4,18,3,7,18,10,2,1,2,1,0,0,20,10,1,3,22,10,3,28,3,0
15:00,Barnsley,Shrewsbury,2,1,H,2,0,H,G Eltringham,14,6,7,4,8,11,9,3,2,5,0,0,20,50,2,3,20,11,12,19,7,0
15:00,Bolton,Cambridge,1,1,D,0,0,D,D Rock,8,10,3,2,13,7,2,2,3,1,0,0,30,10,0,2,18,5,4,20,4,0
15:00,Charlton,Burton,3,2,H,2,1,H,S Gill,13,14,7,4,11,5,3,7,1,1,1,0,35,10,3,5,27,11,10,16,2,1
15:00,Cheltenham,Ipswich,1,1,D,0,0,D,S Stockbridge,7,23,3,9,7,8,5,4,1,1,0,0,10,10,0,2,30,12,9,15,2,0
15:00,Derby,Milton Keynes Dons,1,1,D,1,0,H,B Speedie,28,3,7,2,8,8,10,2,2,2,0,0,20,20,1,2,31,9,12,16,4,0
15:00,Fleetwood Town,Bristol Rvs,1,2,A,1,0,H,S Barrott,9,13,1,6,13,11,5,5,3,1,0,0,30,10,1,3,22,7,10,24,4,0
15:00,Peterboro,Exeter,3,1,H,2,0,H,C Breakspear,15,14,3,1,12,13,9,2,1,2,0,0,10,20,2,4,29,4,11,25,3,0
15:00,Plymouth,Lincoln,0,2,A,0,1,A,T Nield,14,17,2,5,13,13,8,6,1,3,0,0,10,30,1,2,31,7,14,26,4,0
15:00,Port Vale,Oxford,0,0,D,0,0,D,M Woods,11,10,5,4,18,8,13,7,5,2,1,0,75,20,0,0,21,9,20,26,7,1
15:00,Portsmouth,Morecambe,0,0,D,0,0,D,O Yates,15,10,5,3,7,10,4,7,2,2,0,0,20,20,0,0,25,8,11,17,4,0
15:00,Sheffield Weds,Accrington,3,0,H,1,0,H,N Hair,17,11,6,2,11,10,7,2,0,2,0,0,0,20,1,3,28,8,9,21,2,0
15:00,Wycombe,Forest Green,2,0,H,1,0,H,C Boyeson,5,3,2,2,12,12,8,3,0,2,0,0,0,20,1,2,8,4,11,24,2,0
12:00,Exeter,Plymouth,0,1,A,0,0,D,D Drysdale,9,9,2,2,15,7,4,7,2,3,0,0,20,30,0,1,18,4,11,22,5,0
12:30,Cambridge,Peterboro,2,0,H,1,0,H,R Joyce,12,9,4,2,9,15,5,3,1,2,0,0,10,20,1,2,21,6,8,24,3,0
15:00,Accrington,Fleetwood Town,2,5,A,0,2,A,M Edwards,15,2,3,6,14,15,5,6,2,4,1,0,45,40,2,7,17,9,11,29,6,1
15:00,Bristol Rvs,Derby,1,1,D,0,1,A,O Yates,15,10,2,5,7,15,7,5,0,6,0,0,0,60,1,2,25,7,12,22,6,0
15:00,Burton,Sheffield Weds,3,2,H,3,1,H,W Finnie,7,16,3,3,10,9,2,7,1,1,0,0,10,10,4,5,23,6,9,19,2,0
15:00,Forest Green,Barnsley,1,5,A,0,3,A,C Hicks,9,14,2,8,8,9,5,5,0,1,0,0,0,10,3,6,23,10,10,17,1,0
15:00,Ipswich,Charlton,6,0,H,2,0,H,S Barrott,26,5,7,2,9,10,6,0,1,2,0,1,10,45,2,6,31,9,6,19,3,1
15:00,Lincoln,Port Vale,3,2,H,2,2,D,D Rock,10,12,4,4,9,13,4,3,5,4,1,2,75,90,4,5,22,8,7,22,9,3
15:00,Milton Keynes Dons,Cheltenham,2,2,D,1,1,D,B Toner,14,13,5,5,8,17,6,4,1,2,0,0,10,20,2,4,27,10,10,25,3,0
15:00,Morecambe,Wycombe,1,0,H,0,0,D,A Kitchen,10,20,2,4,6,13,4,11,3,2,0,0,30,20,0,1,30,6,15,19,5,0
15:00,Oxford,Bolton,0,1,A,0,1,A,S Stockbridge,24,4,7,2,13,13,7,0,2,5,0,0,20,50,1,1,28,9,7,26,7,0
15:00,Shrewsbury,Portsmouth,1,1,D,0,0,D,T Nield,9,13,4,2,13,12,3,6,3,3,1,0,55,30,0,2,22,6,9,25,6,1
19:45,Accrington,Peterboro,1,2,A,0,2,A,T Reeves,15,12,7,6,12,12,2,5,1,3,0,0,10,30,2,3,27,13,7,24,4,0
19:45,Bristol Rvs,Sheffield Weds,1,2,A,0,2,A,J Smith,7,9,4,3,7,14,6,4,0,3,0,0,0,30,2,3,16,7,10,21,3,0
19:45,Burton,Bolton,1,1,D,0,1,A,A Kitchen,14,22,8,7,7,8,3,8,1,1,0,0,10,10,1,2,36,15,11,15,2,0
19:45,Cambridge,Wycombe,1,2,A,0,2,A,B Speedie,14,13,8,7,8,13,6,7,0,1,0,0,0,10,2,3,27,15,13,21,1,0
19:45,Exeter,Derby,1,2,A,0,0,D,A Woolmer,13,15,4,5,6,8,9,3,0,1,0,0,0,10,0,3,28,9,12,14,1,0
19:45,Forest Green,Fleetwood Town,0,0,D,0,0,D,S Gill,3,15,1,4,12,12,4,3,1,3,0,0,10,30,0,0,18,5,7,24,4,0
19:45,Ipswich,Port Vale,2,1,H,0,1,A,R Lewis,16,6,2,2,5,10,10,3,1,3,0,0,10,30,1,3,22,4,13,15,4,0
19:45,Lincoln,Barnsley,0,0,D,0,0,D,S Mather,9,15,1,1,9,11,4,3,0,3,0,0,0,30,0,0,24,2,7,20,3,0
19:45,Milton Keynes Dons,Charlton,0,1,A,0,0,D,S Allison,11,10,2,3,6,9,12,7,0,3,0,0,0,30,0,1,21,5,19,15,3,0
19:45,Oxford,Portsmouth,1,1,D,1,1,D,D Bourne,21,6,4,4,14,13,10,4,1,6,0,0,10,60,2,2,27,8,14,27,7,0
19:45,Shrewsbury,Plymouth,1,2,A,0,0,D,A Backhouse,5,14,3,5,10,7,2,8,1,3,0,0,10,30,0,3,19,8,10,17,4,0
15:00,Barnsley,Oxford,2,0,H,1,0,H,R Joyce,12,6,6,3,16,15,3,4,1,4,0,0,10,40,1,2,18,9,7,31,5,0
15:00,Bolton,Shrewsbury,1,0,H,0,0,D,T Reeves,14,6,6,0,7,5,9,2,1,2,0,0,10,20,0,1,20,6,11,12,3,0
15:00,Charlton,Morecambe,2,3,A,1,1,D,D Rock,19,12,6,4,9,8,8,1,1,0,0,0,10,0,2,5,31,10,9,17,1,0
15:00,Cheltenham,Forest Green,3,1,H,3,0,H,N Hair,13,6,7,3,13,11,4,1,4,2,0,0,40,20,3,4,19,10,5,24,6,0
15:00,Derby,Burton,1,0,H,0,0,D,B Toner,23,6,10,2,11,9,8,5,1,1,0,0,10,10,0,1,29,12,13,20,2,0
15:00,Fleetwood Town,Milton Keynes Dons,1,0,H,1,0,H,R Welch,19,17,5,3,12,11,6,6,2,4,0,0,20,40,1,1,36,8,12,23,6,0
15:00,Peterboro,Ipswich,0,3,A,0,1,A,G Ward,11,15,4,7,8,11,3,6,1,3,0,0,10,30,1,3,26,11,9,19,4,0
15:00,Plymouth,Cambridge,3,1,H,1,1,D,O Yates,13,8,4,4,8,8,5,4,1,3,0,0,10,30,2,4,21,8,9,16,4,0
15:00,Port Vale,Bristol Rvs,2,0,H,2,0,H,S Gill,11,9,5,0,17,9,5,6,2,2,0,0,20,20,2,2,20,5,11,26,4,0
15:00,Portsmouth,Accrington,1,0,H,0,0,D,D Drysdale,12,18,2,6,6,15,5,7,0,2,0,0,0,20,0,1,30,8,12,21,2,0
15:00,Sheffield Weds,Exeter,2,1,H,0,0,D,D Bourne,17,7,4,3,8,13,4,1,3,1,0,0,30,10,0,3,24,7,5,21,4,0
15:00,Wycombe,Lincoln,0,2,A,0,1,A,A Backhouse,15,14,6,4,9,13,7,3,0,3,0,0,0,30,1,2,29,10,10,22,3,0
19:45,Barnsley,Ipswich,0,3,A,0,2,A,B Toner,10,10,3,5,18,17,2,3,3,3,0,0,30,30,2,3,20,8,5,35,6,0
19:45,Bolton,Accrington,0,1,A,0,1,A,J Linington,11,12,6,2,10,14,10,4,0,0,0,0,0,0,1,1,23,8,14,24,0,0
19:45,Lincoln,Burton,0,1,A,0,0,D,P Howard,13,10,1,3,4,11,3,4,0,0,0,0,0,0,0,1,23,4,7,15,0,0
19:45,Oxford,Cheltenham,4,0,H,1,0,H,W Finnie,13,10,7,4,12,12,4,2,0,3,0,0,0,30,1,4,23,11,6,24,3,0
19:45,Plymouth,Bristol Rvs,2,0,H,0,0,D,C Hicks,25,3,7,1,10,17,10,2,1,1,0,1,10,35,0,2,28,8,12,27,2,1
15:00,Accrington,Cambridge,1,2,A,0,1,A,R Welch,15,15,6,6,18,11,6,4,2,2,0,0,20,20,1,3,30,12,10,29,4,0
15:00,Bolton,Fleetwood Town,2,0,H,1,0,H,B Speedie,11,14,3,5,13,12,8,4,2,3,0,1,20,55,1,2,25,8,12,25,5,1
15:00,Charlton,Port Vale,3,2,H,1,0,H,C Brook,10,12,4,4,15,11,4,8,4,1,0,0,40,10,1,5,22,8,12,26,5,0
15:00,Derby,Portsmouth,1,1,D,0,1,A,L Swabey,15,8,5,6,12,15,10,3,0,2,0,0,0,20,1,2,23,11,13,27,2,0
15:00,Forest Green,Oxford,0,3,A,0,1,A,T Reeves,2,15,1,6,5,8,1,5,0,0,0,0,0,0,1,3,17,7,6,13,0,0
15:00,Ipswich,Exeter,6,0,H,5,0,H,S Oldham,14,5,6,1,10,9,4,2,2,1,0,0,20,10,5,6,19,7,6,19,3,0
15:00,Milton Keynes Dons,Barnsley,4,4,D,0,1,A,A Backhouse,17,17,8,9,9,7,7,3,2,2,0,0,20,20,1,8,34,17,10,16,4,0
15:00,Morecambe,Lincoln,3,2,H,0,1,A,S Allison,11,12,5,5,13,13,3,6,3,3,0,0,30,30,1,5,23,10,9,26,6,0
15:00,Peterboro,Bristol Rvs,0,0,D,0,0,D,D Drysdale,23,6,5,2,8,10,12,2,3,5,0,0,30,50,0,0,29,7,14,18,8,0
15:00,Plymouth,Burton,1,0,H,1,0,H,L Smith,22,7,4,1,8,14,6,4,0,3,0,0,0,30,1,1,29,5,10,22,3,0
15:00,Shrewsbury,Sheffield Weds,0,3,A,0,1,A,D Whitestone,13,20,3,6,14,7,5,6,3,2,0,0,30,20,1,3,33,9,11,21,5,0
15:00,Wycombe,Cheltenham,0,3,A,0,1,A,R Joyce,14,18,2,7,10,14,8,1,1,3,0,0,10,30,1,3,32,9,9,24,4,0
19:45,Shrewsbury,Bristol Rvs,2,1,H,1,0,H,L Swabey,6,21,2,4,14,10,3,7,4,2,0,0,40,20,1,3,27,6,10,24,6,0
19:45,Burton,Cambridge,1,0,H,1,0,H,A Haines,9,10,2,1,10,5,4,8,2,1,0,0,20,10,1,1,19,3,12,15,3,0
12:00,Barnsley,Peterboro,0,2,A,0,1,A,S Oldham,14,10,2,5,10,15,10,3,0,1,0,0,0,10,1,2,24,7,13,25,1,0
12:00,Bristol Rvs,Bolton,2,3,A,1,1,D,W Finnie,12,14,6,5,13,14,5,8,1,3,0,0,10,30,2,5,26,11,13,27,4,0
12:00,Burton,Milton Keynes Dons,0,0,D,0,0,D,S Stockbridge,5,31,2,6,13,10,3,12,1,1,0,0,10,10,0,0,36,8,15,23,2,0
12:00,Cambridge,Forest Green,2,0,H,2,0,H,B Toner,12,5,3,0,8,13,7,2,0,2,0,0,0,20,2,2,17,3,9,21,2,0
12:00,Cheltenham,Charlton,2,2,D,0,1,A,T Nield,20,16,7,6,7,8,5,3,0,0,0,0,0,0,1,4,36,13,8,15,0,0
12:00,Exeter,Morecambe,3,2,H,0,0,D,C Brook,15,14,3,6,12,10,7,1,4,3,0,0,40,30,0,5,29,9,8,22,7,0
12:00,Fleetwood Town,Ipswich,2,2,D,0,0,D,R Joyce,8,21,4,2,5,14,4,8,0,3,0,1,0,55,0,4,29,6,12,19,3,1
12:00,Lincoln,Shrewsbury,1,0,H,0,0,D,A Haines,13,13,4,3,6,11,1,4,2,1,0,1,20,35,0,1,26,7,5,17,3,1
12:00,Oxford,Accrington,1,2,A,1,0,H,S Allison,25,9,6,4,14,11,8,3,1,2,0,0,10,20,1,3,34,10,11,25,3,0
12:00,Port Vale,Plymouth,1,3,A,1,2,A,S Mather,9,11,2,4,11,10,4,1,0,1,0,0,0,10,3,4,20,6,5,21,1,0
12:00,Portsmouth,Wycombe,2,2,D,1,1,D,S Gill,21,8,9,5,5,16,10,1,1,1,0,0,10,10,2,4,29,14,11,21,2,0
12:00,Sheffield Weds,Derby,1,0,H,1,0,H,L Doughty,18,10,4,6,10,8,2,6,3,2,0,1,30,45,1,1,28,10,8,18,5,1
15:00,Bolton,Milton Keynes Dons,3,3,D,1,1,D,M Coy,17,10,4,4,15,10,3,2,1,0,0,0,10,0,2,6,27,8,5,25,1,0
15:00,Cambridge,Oxford,1,1,D,0,1,A,D Rock,9,11,1,3,7,12,3,4,1,2,0,0,10,20,1,2,20,4,7,19,3,0
15:00,Crewe,Cheltenham,1,1,D,1,1,D,B Toner,7,12,1,6,15,14,3,2,1,1,0,0,10,10,2,2,19,7,5,29,2,0
15:00,Doncaster,AFC Wimbledon,1,2,A,0,0,D,S Barrott,9,6,1,3,11,15,6,6,0,3,0,0,0,30,0,3,15,4,12,26,3,0
15:00,Fleetwood Town,Portsmouth,0,1,A,0,0,D,B Speedie,13,9,4,2,7,11,6,2,0,3,0,0,0,30,0,1,22,6,8,18,3,0
15:00,Gillingham,Lincoln,1,1,D,1,1,D,T Bramall,17,10,6,4,12,9,5,4,2,2,0,0,20,20,2,2,27,10,9,21,4,0
15:00,Ipswich,Morecambe,2,2,D,0,1,A,C Hicks,13,6,3,2,18,13,10,3,3,2,0,0,30,20,1,4,19,5,13,31,5,0
15:00,Rotherham,Plymouth,2,0,H,2,0,H,S Stockbridge,18,7,6,2,16,7,10,8,2,0,0,0,20,0,2,2,25,8,18,23,2,0
15:00,Shrewsbury,Burton,0,1,A,0,1,A,A Backhouse,12,14,2,5,12,14,8,3,1,2,0,0,10,20,1,1,26,7,11,26,3,0
15:00,Sunderland,Wigan,2,1,H,1,1,D,R Madley,16,8,3,3,16,20,7,2,1,4,0,0,10,40,2,3,24,6,9,36,5,0
15:00,Wycombe,Accrington,2,1,H,2,0,H,C Breakspear,17,8,4,3,14,14,6,3,0,1,0,0,0,10,2,3,25,7,9,28,1,0
17:30,Charlton,Sheffield Weds,0,0,D,0,0,D,W Finnie,11,6,0,1,16,14,9,6,1,3,0,0,10,30,0,0,17,1,15,30,4,0
15:00,Accrington,Cambridge,2,1,H,2,0,H,B Speedie,14,16,6,4,15,12,3,11,3,0,0,0,30,0,2,3,30,10,14,27,3,0
15:00,AFC Wimbledon,Bolton,3,3,D,1,2,A,P Wright,16,8,4,4,12,9,6,3,4,2,0,0,40,20,3,6,24,8,9,21,6,0
15:00,Burton,Ipswich,2,1,H,1,1,D,S Purkiss,11,11,2,3,17,8,3,7,3,0,0,0,30,0,2,3,22,5,10,25,3,0
15:00,Cheltenham,Wycombe,1,3,A,1,1,D,C Boyeson,13,11,6,6,9,9,7,8,2,0,0,0,20,0,2,4,24,12,15,18,2,0
15:00,Lincoln,Fleetwood Town,2,1,H,0,1,A,J Oldham,9,11,3,7,8,16,3,4,3,3,0,0,30,30,1,3,20,10,7,24,6,0
15:00,Milton Keynes Dons,Sunderland,1,2,A,0,1,A,J Bell,17,7,8,5,8,12,6,7,2,4,0,0,20,40,1,3,24,13,13,20,6,0
15:00,Morecambe,Shrewsbury,2,0,H,2,0,H,D Bourne,10,11,6,1,13,18,4,7,2,3,0,0,20,30,2,2,21,7,11,31,5,0
15:00,Oxford,Charlton,2,1,H,2,1,H,T Bramall,11,10,5,3,10,16,5,6,2,2,0,0,20,20,3,3,21,8,11,26,4,0
15:00,Plymouth,Gillingham,1,0,H,0,0,D,C Breakspear,17,5,3,1,8,11,9,5,1,2,0,0,10,20,0,1,22,4,14,19,3,0
15:00,Portsmouth,Crewe,2,0,H,0,0,D,W Finnie,15,4,5,1,10,9,6,3,0,1,0,0,0,10,0,2,19,6,9,19,1,0
15:00,Sheffield Weds,Doncaster,2,0,H,0,0,D,R Joyce,11,12,4,3,13,13,6,4,0,3,0,0,0,30,0,2,23,7,10,26,3,0
15:00,Wigan,Rotherham,1,0,H,0,0,D,R Lewis,9,11,2,2,15,16,4,6,4,1,0,0,40,10,0,1,20,4,10,31,5,0
19:45,Accrington,Doncaster,1,0,H,1,0,H,S Oldham,14,3,5,1,10,8,7,5,3,0,0,0,30,0,1,1,17,6,12,18,3,0
19:45,AFC Wimbledon,Gillingham,1,1,D,0,0,D,C Brook,16,5,7,3,17,15,3,3,4,4,0,1,40,65,0,2,21,10,6,32,8,1
19:45,Burton,Sunderland,1,0,H,0,0,D,D Bourne,12,20,1,7,10,6,5,9,2,2,0,0,20,20,0,1,32,8,14,16,4,0
19:45,Cheltenham,Ipswich,2,1,H,0,1,A,P Wright,9,12,4,3,9,8,2,5,3,1,0,0,30,10,1,3,21,7,7,17,4,0
19:45,Lincoln,Bolton,0,1,A,0,0,D,S Barrott,15,10,6,2,9,10,2,4,1,0,0,0,10,0,0,1,25,8,6,19,1,0
19:45,Milton Keynes Dons,Charlton,2,1,H,1,1,D,C Breakspear,12,7,3,3,10,17,4,3,2,2,0,0,20,20,2,3,19,6,7,27,4,0
19:45,Morecambe,Rotherham,0,1,A,0,0,D,D Webb,8,15,0,8,9,16,7,10,2,2,0,0,20,20,0,1,23,8,17,25,4,0
19:45,Oxford,Crewe,1,0,H,1,0,H,R Madley,13,7,1,1,11,12,9,3,2,3,0,0,20,30,1,1,20,2,12,23,5,0
19:45,Plymouth,Cambridge,1,1,D,0,0,D,C Sarginson,11,7,4,3,10,12,7,3,2,5,0,0,20,50,0,2,18,7,10,22,7,0
19:45,Portsmouth,Shrewsbury,1,0,H,1,0,H,T Kettle,9,10,2,4,12,13,5,4,1,1,0,0,10,10,1,1,19,6,9,25,2,0
19:45,Sheffield Weds,Fleetwood Town,1,0,H,1,0,H,S Stockbridge,12,11,5,5,14,16,5,2,4,5,0,0,40,50,1,1,23,10,7,30,9,0
19:45,Wigan,Wycombe,1,1,D,0,0,D,A Backhouse,8,12,3,4,9,18,1,4,3,2,0,0,30,20,0,2,20,7,5,27,5,0
13:00,Rotherham,Sheffield Weds,0,2,A,0,0,D,M Edwards,14,7,2,5,17,12,8,0,1,4,0,0,10,40,0,2,21,7,8,29,5,0
15:00,Bolton,Oxford,2,1,H,1,1,D,N Hair,14,13,4,7,7,17,7,6,0,3,0,0,0,30,2,3,27,11,13,24,3,0
15:00,Cambridge,Burton,3,0,H,0,0,D,B Toner,7,19,2,9,10,13,8,4,1,2,0,0,10,20,0,3,26,11,12,23,3,0
15:00,Charlton,Wigan,0,2,A,0,0,D,C Hicks,9,13,1,4,17,13,5,3,3,1,0,0,30,10,0,2,22,5,8,30,4,0
15:00,Crewe,Accrington,0,1,A,0,1,A,D Drysdale,10,12,3,2,19,16,6,6,3,6,1,0,55,60,1,1,22,5,12,35,9,1
15:00,Doncaster,Portsmouth,0,0,D,0,0,D,C Boyeson,9,12,3,6,16,14,6,5,2,2,0,0,20,20,0,0,21,9,11,30,4,0
15:00,Fleetwood Town,Cheltenham,3,2,H,1,1,D,A Haines,8,15,6,7,5,7,7,9,1,4,0,0,10,40,2,5,23,13,16,12,5,0
15:00,Gillingham,Morecambe,2,1,H,1,1,D,T Nield,10,11,3,2,18,11,2,3,1,2,0,0,10,20,2,3,21,5,5,29,3,0
15:00,Ipswich,Milton Keynes Dons,2,2,D,1,0,H,J Smith,11,19,4,8,13,8,8,8,2,1,0,0,20,10,1,4,30,12,16,21,3,0
15:00,Shrewsbury,Plymouth,0,3,A,0,1,A,P Howard,17,5,1,4,19,8,11,1,2,1,0,0,20,10,1,3,22,5,12,27,3,0
15:00,Sunderland,AFC Wimbledon,1,0,H,0,0,D,J Oldham,12,5,6,2,13,11,8,3,3,1,0,0,30,10,0,1,17,8,11,24,4,0
15:00,Wycombe,Lincoln,1,0,H,1,0,H,J Bell,15,8,1,4,21,11,7,1,3,1,0,0,30,10,1,1,23,5,8,32,4,0
19:45,Burton,Cheltenham,1,1,D,0,1,A,S Oldham,14,7,3,2,12,10,5,4,2,1,0,0,20,10,1,2,21,5,9,22,3,0
13:00,Rotherham,Doncaster,2,0,H,2,0,H,M Coy,15,9,6,1,8,8,2,4,3,0,0,1,30,25,2,2,24,7,6,16,3,1
15:00,Cambridge,Bolton,1,0,H,1,0,H,T Nield,6,13,3,1,12,11,2,5,4,3,0,0,40,30,1,1,19,4,7,23,7,0
15:00,Charlton,Crewe,2,0,H,2,0,H,J Bell,19,13,7,5,11,8,7,5,1,2,0,0,10,20,2,2,32,12,12,19,3,0
15:00,Ipswich,AFC Wimbledon,2,2,D,0,0,D,D Rock,11,11,5,4,7,12,4,6,1,3,0,0,10,30,0,4,22,9,10,19,4,0
15:00,Milton Keynes Dons,Accrington,2,0,H,1,0,H,D Bourne,12,13,5,2,13,13,1,5,4,2,0,0,40,20,1,2,25,7,6,26,6,0
15:00,Morecambe,Sheffield Weds,1,0,H,0,0,D,A Backhouse,6,13,1,2,11,6,5,7,2,1,0,0,20,10,0,1,19,3,12,17,3,0
15:00,Oxford,Lincoln,3,1,H,2,0,H,W Finnie,12,12,8,4,8,10,2,8,0,1,0,0,0,10,2,4,24,12,10,18,1,0
15:00,Plymouth,Fleetwood Town,1,1,D,1,1,D,S Purkiss,13,8,4,3,14,13,3,3,0,2,0,0,0,20,2,2,21,7,6,27,2,0
15:00,Shrewsbury,Gillingham,2,1,H,0,1,A,S Allison,11,10,5,3,9,10,6,7,0,1,1,1,25,35,1,3,21,8,13,19,1,2
15:00,Sunderland,Wycombe,3,1,H,2,0,H,J Busby,10,16,4,3,11,9,1,5,1,1,0,0,10,10,2,4,26,7,6,20,2,0
15:00,Wigan,Portsmouth,1,0,H,0,0,D,C Sarginson,4,10,2,2,14,12,2,3,1,0,0,0,10,0,0,1,14,4,5,26,1,0
15:00,Accrington,Shrewsbury,1,0,H,1,0,H,A Coggins,13,9,7,3,16,17,3,1,1,4,0,0,10,40,1,1,22,10,4,33,5,0
15:00,AFC Wimbledon,Oxford,3,1,H,0,1,A,B Huxtable,14,17,8,6,9,12,5,13,3,1,0,0,30,10,1,4,31,14,18,21,4,0
15:00,Cheltenham,Milton Keynes Dons,1,1,D,1,0,H,S Allison,10,14,4,3,17,6,1,4,3,2,0,0,30,20,1,2,24,7,5,23,5,0
20:00,Bolton,Burton,0,0,D,0,0,D,J Smith,25,10,4,1,7,17,14,3,2,3,0,1,20,55,0,0,35,5,17,24,5,1
15:00,Burton,Gillingham,1,1,D,0,1,A,C Boyeson,14,15,7,4,4,15,4,7,0,2,0,0,0,20,1,2,29,11,11,19,2,0
15:00,Cambridge,Lincoln,1,5,A,0,3,A,S Purkiss,14,18,3,12,4,11,10,1,3,0,0,0,30,0,3,6,32,15,11,15,3,0
15:00,Charlton,Cheltenham,1,2,A,0,2,A,A Davies,14,16,1,8,6,14,3,3,2,1,0,0,20,10,2,3,30,9,6,20,3,0
15:00,Ipswich,Bolton,2,5,A,2,3,A,R Madley,7,14,3,7,11,14,1,6,1,2,0,0,10,20,5,7,21,10,7,25,3,0
15:00,Milton Keynes Dons,Portsmouth,1,0,H,0,0,D,M Edwards,13,6,6,2,10,19,6,7,2,1,0,0,20,10,0,1,19,8,13,29,3,0
15:00,Morecambe,AFC Wimbledon,3,4,A,0,1,A,S Stockbridge,7,19,5,5,14,8,3,5,2,4,0,0,20,40,1,7,26,10,8,22,6,0
15:00,Oxford,Wycombe,0,0,D,0,0,D,C Sarginson,11,9,4,2,12,15,8,8,4,1,0,0,40,10,0,0,20,6,16,27,5,0
15:00,Plymouth,Sheffield Weds,3,0,H,2,0,H,B Speedie,13,14,6,3,12,10,6,4,1,4,0,0,10,40,2,3,27,9,10,22,5,0
15:00,Rotherham,Fleetwood Town,2,4,A,2,1,H,C Hicks,19,9,5,5,9,15,6,2,0,3,0,0,0,30,3,6,28,10,8,24,3,0
15:00,Shrewsbury,Crewe,1,1,D,1,1,D,S Barrott,12,18,5,6,16,9,5,8,4,5,0,0,40,50,2,2,30,11,13,25,9,0
15:00,Sunderland,Accrington,2,1,H,1,1,D,A Backhouse,20,21,5,4,14,15,5,6,4,3,0,0,40,30,2,3,41,9,11,29,7,0
15:00,Wigan,Doncaster,2,1,H,1,1,D,T Nield,13,3,6,1,10,7,6,3,4,3,0,0,40,30,2,3,16,7,9,17,7,0
19:45,Lincoln,Rotherham,1,1,D,0,1,A,S Barrott,9,26,3,8,13,19,5,8,1,2,0,0,10,20,1,2,35,11,13,32,3,0
15:00,Accrington,Wigan,1,4,A,0,2,A,A Haines,13,17,5,8,6,13,2,9,2,2,0,0,20,20,2,5,30,13,11,19,4,0
15:00,AFC Wimbledon,Plymouth,0,1,A,0,0,D,T Nield,12,9,6,3,10,9,5,3,2,2,0,0,20,20,0,1,21,9,8,19,4,0
15:00,Bolton,Rotherham,0,2,A,0,2,A,J Bell,17,8,4,3,8,16,11,4,3,3,0,0,30,30,2,2,25,7,15,24,6,0
15:00,Cheltenham,Oxford,1,0,H,0,0,D,P Howard,9,11,1,5,9,11,8,10,2,1,0,0,20,10,0,1,20,6,18,20,3,0
15:00,Crewe,Burton,2,0,H,1,0,H,R Joyce,9,19,4,3,10,12,4,4,1,2,0,1,10,45,1,2,28,7,8,22,3,1
15:00,Doncaster,Morecambe,1,0,H,0,0,D,W Finnie,12,11,5,3,10,4,6,6,0,0,0,0,0,0,0,1,23,8,12,14,0,0
15:00,Fleetwood Town,Sunderland,2,2,D,0,1,A,N Hair,12,14,4,5,8,12,7,4,2,1,0,0,20,10,1,4,26,9,11,20,3,0
15:00,Gillingham,Milton Keynes Dons,1,4,A,1,2,A,J Busby,8,19,5,10,10,3,2,8,1,2,1,0,35,20,3,5,27,15,10,13,3,1
15:00,Lincoln,Ipswich,0,1,A,0,1,A,B Speedie,10,5,2,2,3,14,8,3,1,2,0,0,10,20,1,1,15,4,11,17,3,0
15:00,Portsmouth,Cambridge,1,2,A,0,1,A,G Ward,8,8,2,4,10,8,7,10,3,3,0,0,30,30,1,3,16,6,17,18,6,0
15:00,Sheffield Weds,Shrewsbury,1,1,D,1,1,D,B Toner,9,11,2,4,10,12,5,6,1,2,0,0,10,20,2,2,20,6,11,22,3,0
15:00,Wycombe,Charlton,2,1,H,1,0,H,P Wright,17,13,6,1,11,16,7,10,0,5,0,0,0,50,1,3,30,7,17,27,5,0
19:45,Crewe,Morecambe,1,3,A,0,2,A,P Howard,13,13,9,4,8,10,6,3,0,3,0,0,0,30,2,4,26,13,9,18,3,0
19:45,Gillingham,Charlton,1,1,D,0,1,A,K Stroud,11,18,1,6,11,9,2,5,2,0,0,0,20,0,1,2,29,7,7,20,2,0
19:45,Portsmouth,Plymouth,2,2,D,1,0,H,C Brook,15,15,4,8,11,6,9,4,3,3,0,0,30,30,1,4,30,12,13,17,6,0
15:00,Burton,Lincoln,1,2,A,0,1,A,C Hicks,27,12,6,5,13,5,13,1,1,2,0,0,10,20,1,3,39,11,14,18,3,0
15:00,Cambridge,Fleetwood Town,2,2,D,1,1,D,P Howard,12,7,4,2,16,10,4,3,1,0,0,0,10,0,2,4,19,6,7,26,1,0
15:00,Charlton,Portsmouth,2,2,D,0,1,A,A Coggins,12,12,7,6,14,10,11,4,2,2,0,0,20,20,1,4,24,13,15,24,4,0
15:00,Ipswich,Sheffield Weds,1,1,D,0,1,A,A Davies,10,6,5,2,8,9,4,5,2,0,0,0,20,0,1,2,16,7,9,17,2,0
15:00,Milton Keynes Dons,Wycombe,1,0,H,1,0,H,S Oldham,24,7,6,1,5,18,6,5,1,0,0,1,10,25,1,1,31,7,11,23,1,1
15:00,Morecambe,Accrington,3,3,D,2,2,D,M Edwards,8,25,3,9,11,10,4,7,1,1,1,0,35,10,4,6,33,12,11,21,2,1
15:00,Oxford,Gillingham,1,1,D,1,1,D,D Drysdale,25,7,7,4,7,11,12,2,0,2,0,0,0,20,2,2,32,11,14,18,2,0
15:00,Plymouth,Doncaster,2,1,H,0,0,D,T Kettle,16,13,10,4,13,16,7,7,4,5,0,0,40,50,0,3,29,14,14,29,9,0
15:00,Rotherham,Crewe,1,1,D,0,0,D,S Allison,23,3,4,3,12,8,8,0,1,1,1,0,35,10,0,2,26,7,8,20,2,1
15:00,Shrewsbury,AFC Wimbledon,2,1,H,1,1,D,J Bell,11,11,5,3,8,11,7,2,1,1,0,0,10,10,2,3,22,8,9,19,2,0
15:00,Sunderland,Bolton,1,0,H,1,0,H,S Purkiss,14,15,4,4,13,14,2,7,1,3,0,0,10,30,1,1,29,8,9,27,4,0
15:00,Wigan,Cheltenham,2,0,H,1,0,H,J Smith,15,9,5,2,11,7,6,3,3,1,0,0,30,10,1,2,24,7,9,18,4,0
19:45,Burton,Portsmouth,2,1,H,1,0,H,T Nield,14,12,6,2,21,5,6,5,3,4,0,0,30,40,1,3,26,8,11,26,7,0
19:45,Cambridge,Gillingham,0,2,A,0,1,A,J Bell,17,7,5,4,4,9,7,6,1,3,0,0,10,30,1,2,24,9,13,13,4,0
19:45,Charlton,Bolton,1,4,A,1,1,D,L Swabey,9,12,2,6,12,21,2,1,2,2,0,0,20,20,2,5,21,8,3,33,4,0
19:45,Ipswich,Doncaster,6,0,H,2,0,H,C Brook,11,1,7,1,6,11,8,0,1,2,0,0,10,20,2,6,12,8,8,17,3,0
19:45,Milton Keynes Dons,Fleetwood Town,3,3,D,2,2,D,P Wright,16,13,5,5,4,10,5,4,1,2,0,0,10,20,4,6,29,10,9,14,3,0
19:45,Morecambe,Lincoln,2,0,H,0,0,D,B Toner,8,11,2,3,6,6,7,11,1,0,0,0,10,0,0,2,19,5,18,12,1,0
19:45,Oxford,Accrington,5,1,H,2,0,H,R Lewis,16,14,10,3,15,10,4,5,4,2,0,0,40,20,2,6,30,13,9,25,6,0
19:45,Plymouth,Crewe,1,1,D,0,1,A,N Hair,26,10,5,5,7,8,6,4,3,3,0,0,30,30,1,2,36,10,10,15,6,0
19:45,Rotherham,AFC Wimbledon,3,0,H,2,0,H,A Haines,14,4,6,1,15,9,7,1,1,1,0,0,10,10,2,3,18,7,8,24,2,0
19:45,Shrewsbury,Wycombe,1,2,A,0,0,D,R Joyce,14,10,7,4,15,15,7,1,3,3,0,0,30,30,0,3,24,11,8,30,6,0
19:45,Sunderland,Cheltenham,5,0,H,3,0,H,C Sarginson,22,6,10,2,4,10,8,3,0,3,0,0,0,30,3,5,28,12,11,14,3,0
19:45,Wigan,Sheffield Weds,1,2,A,0,1,A,S Barrott,15,10,5,4,12,15,10,2,2,3,0,0,20,30,1,3,25,9,12,27,5,0
15:00,Accrington,Ipswich,2,1,H,0,1,A,M Coy,10,2,3,1,13,12,4,3,2,1,0,0,20,10,1,3,12,4,7,25,3,0
15:00,AFC Wimbledon,Burton,1,1,D,0,0,D,L Swabey,14,8,2,2,10,7,5,7,0,2,0,0,0,20,0,2,22,4,12,17,2,0
15:00,Bolton,Shrewsbury,2,1,H,2,0,H,M Edwards,10,13,6,2,10,7,0,6,1,1,0,0,10,10,2,3,23,8,6,17,2,0
15:00,Cheltenham,Rotherham,0,2,A,0,0,D,D Drysdale,8,17,1,10,7,10,3,11,0,0,0,0,0,0,0,2,25,11,14,17,0,0
15:00,Crewe,Cambridge,2,2,D,2,0,H,T Reeves,8,15,3,3,10,13,3,9,2,0,0,0,20,0,2,4,23,6,12,23,2,0
15:00,Doncaster,Milton Keynes Dons,2,1,H,1,1,D,A Kitchen,6,8,3,5,14,12,3,7,3,1,0,0,30,10,2,3,14,8,10,26,4,0
15:00,Fleetwood Town,Charlton,1,2,A,0,1,A,O Langford,15,13,4,5,12,11,4,6,2,2,0,0,20,20,1,3,28,9,10,23,4,0
15:00,Gillingham,Wigan,0,2,A,0,0,D,N Hair,10,15,4,5,6,13,5,8,1,2,0,0,10,20,0,2,25,9,13,19,3,0
15:00,Lincoln,Plymouth,2,2,D,0,1,A,A Woolmer,10,13,3,4,15,9,4,6,4,2,0,0,40,20,1,4,23,7,10,24,6,0
15:00,Portsmouth,Sunderland,4,0,H,3,0,H,B Toner,14,10,7,2,18,10,7,6,2,1,0,0,20,10,3,4,24,9,13,28,3,0
15:00,Sheffield Weds,Oxford,1,2,A,0,1,A,A Haines,14,15,6,4,10,14,3,10,2,2,0,0,20,20,1,3,29,10,13,24,4,0
15:00,Wycombe,Morecambe,4,3,H,0,2,A,T Reeves,17,13,5,8,7,9,9,2,0,0,0,0,0,0,2,7,30,13,11,16,0,0
15:00,Ipswich,Shrewsbury,2,1,H,1,1,D,W Finnie,8,5,3,2,12,15,4,2,3,1,0,0,30,10,2,3,13,5,6,27,4,0
15:00,Plymouth,Burton,2,1,H,2,0,H,A Coggins,17,8,4,2,8,16,7,4,1,0,0,0,10,0,2,3,25,6,11,24,1,0
15:00,Sheffield Weds,Bolton,1,0,H,0,0,D,D Rock,8,12,2,1,15,10,3,4,2,2,0,0,20,20,0,1,20,3,7,25,4,0
15:00,Wycombe,Gillingham,2,0,H,2,0,H,K Friend,15,14,5,5,15,14,5,3,0,1,0,0,0,10,2,2,29,10,8,29,1,0
19:45,Burton,Morecambe,3,2,H,2,1,H,M Coy,22,9,8,3,8,9,8,8,4,1,0,0,40,10,3,5,31,11,16,17,5,0
15:00,AFC Wimbledon,Sheffield Weds,2,2,D,0,1,A,C Sarginson,9,14,5,9,13,12,2,2,0,2,0,0,0,20,1,4,23,14,4,25,2,0
15:00,Bolton,Wigan,0,4,A,0,1,A,C Breakspear,10,13,3,7,13,14,3,1,3,4,0,0,30,40,1,4,23,10,4,27,7,0
15:00,Cambridge,Ipswich,2,2,D,1,2,A,L Doughty,9,16,3,3,12,11,4,4,0,1,0,0,0,10,3,4,25,6,8,23,1,0
15:00,Cheltenham,Accrington,1,0,H,0,0,D,J Oldham,15,10,4,3,14,16,10,5,2,1,0,0,20,10,0,1,25,7,15,30,3,0
15:00,Doncaster,Wycombe,0,2,A,0,2,A,S Stockbridge,13,8,4,3,14,9,6,2,2,1,0,0,20,10,2,2,21,7,8,23,3,0
15:00,Fleetwood Town,Crewe,3,0,H,0,0,D,M Edwards,16,8,6,1,9,10,10,5,2,4,0,0,20,40,0,3,24,7,15,19,6,0
15:00,Gillingham,Sunderland,1,2,A,1,1,D,L Swabey,25,14,8,5,14,9,6,5,1,2,0,1,10,45,2,3,39,13,11,23,3,1
15:00,Lincoln,Charlton,2,1,H,0,0,D,D Webb,12,5,5,2,10,8,10,3,1,4,0,0,10,40,0,3,17,7,13,18,5,0
15:00,Oxford,Plymouth,1,3,A,1,2,A,J Bell,14,12,2,5,13,6,7,1,0,1,0,0,0,10,3,4,26,7,8,19,1,0
15:00,Rotherham,Portsmouth,4,1,H,1,0,H,A Backhouse,14,7,10,3,14,14,4,3,2,2,0,0,20,20,1,5,21,13,7,28,4,0
15:00,Shrewsbury,Milton Keynes Dons,1,0,H,0,0,D,C Brook,4,13,3,2,14,6,3,11,2,1,0,0,20,10,0,1,17,5,14,20,3,0
19:45,Cambridge,Sheffield Weds,1,1,D,1,0,H,S Oldham,12,20,4,7,8,8,7,8,1,2,0,0,10,20,1,2,32,11,15,16,3,0
19:45,Charlton,Accrington,2,3,A,1,1,D,S Allison,16,16,6,9,16,14,8,5,4,3,0,0,40,30,2,5,32,15,13,30,7,0
19:45,Cheltenham,Morecambe,3,1,H,1,1,D,B Speedie,16,5,7,2,7,8,5,4,0,2,0,0,0,20,2,4,21,9,9,15,2,0
19:45,Crewe,Sunderland,0,4,A,0,2,A,C Boyeson,16,14,3,8,17,14,9,6,1,2,0,0,10,20,2,4,30,11,15,31,3,0
19:45,Fleetwood Town,Burton,0,1,A,0,1,A,S Mather,11,14,2,6,9,17,3,9,0,2,0,0,0,20,1,1,25,8,12,26,2,0
19:45,Gillingham,Doncaster,1,0,H,0,0,D,S Purkiss,9,13,2,3,14,9,8,1,2,2,0,0,20,20,0,1,22,5,9,23,4,0
19:45,Lincoln,AFC Wimbledon,0,1,A,0,1,A,P Howard,16,12,4,1,7,6,5,3,3,3,0,0,30,30,1,1,28,5,8,13,6,0
19:45,Oxford,Shrewsbury,2,0,H,0,0,D,C Hicks,13,10,3,0,11,10,4,4,0,0,0,0,0,0,0,2,23,3,8,21,0,0
19:45,Plymouth,Bolton,3,0,H,2,0,H,K Stroud,21,13,7,4,7,10,11,2,1,3,0,0,10,30,2,3,34,11,13,17,4,0
19:45,Portsmouth,Ipswich,0,4,A,0,1,A,J Smith,8,8,2,5,9,17,5,3,2,2,0,0,20,20,1,4,16,7,8,26,4,0
19:45,Rotherham,Wycombe,0,0,D,0,0,D,R Madley,8,10,2,1,14,8,7,5,2,1,0,0,20,10,0,0,18,3,12,22,3,0
19:45,Wigan,Milton Keynes Dons,1,2,A,1,2,A,D Drysdale,12,12,3,5,8,8,13,3,1,3,0,0,10,30,3,3,24,8,16,16,4,0
15:00,Accrington,Portsmouth,2,2,D,0,1,A,G Eltringham,13,19,3,9,8,16,5,6,2,2,0,0,20,20,1,4,32,12,11,24,4,0
15:00,AFC Wimbledon,Wigan,0,2,A,0,0,D,O Yates,6,15,3,6,11,12,1,7,0,3,0,0,0,30,0,2,21,9,8,23,3,0
15:00,Bolton,Gillingham,2,2,D,0,2,A,B Toner,22,15,9,7,11,12,11,4,1,3,0,0,10,30,2,4,37,16,15,23,4,0
15:00,Burton,Oxford,1,3,A,0,2,A,S Barrott,7,22,1,9,13,10,7,6,3,1,0,0,30,10,2,4,29,10,13,23,4,0
15:00,Doncaster,Cheltenham,3,2,H,2,0,H,N Hair,12,20,5,7,7,8,6,6,1,0,0,0,10,0,2,5,32,12,12,15,1,0
15:00,Ipswich,Fleetwood Town,2,1,H,0,0,D,S Allison,16,7,5,4,13,12,5,2,2,3,0,0,20,30,0,3,23,9,7,25,5,0
15:00,Milton Keynes Dons,Rotherham,0,3,A,0,1,A,C Sarginson,11,11,2,5,6,20,3,7,1,1,0,0,10,10,1,3,22,7,10,26,2,0
15:00,Morecambe,Plymouth,1,1,D,1,1,D,M Edwards,15,15,4,6,10,8,3,4,1,2,0,0,10,20,2,2,30,10,7,18,3,0
15:00,Sheffield Weds,Lincoln,1,1,D,0,0,D,M Coy,12,10,3,5,11,10,10,5,0,1,0,0,0,10,0,2,22,8,15,21,1,0
15:00,Shrewsbury,Cambridge,4,1,H,1,0,H,S Mather,16,5,9,1,7,10,4,5,1,5,0,1,10,75,1,5,21,10,9,17,6,1
15:00,Sunderland,Charlton,0,1,A,0,0,D,D Drysdale,18,12,5,3,5,17,7,6,2,2,0,0,20,20,0,1,30,8,13,22,4,0
15:00,Wycombe,Crewe,2,1,H,1,0,H,S Martin,21,13,7,6,5,10,7,4,0,1,0,0,0,10,1,3,34,13,11,15,1,0
19:45,Doncaster,Cambridge,1,1,D,0,1,A,A Haines,12,9,5,0,10,6,7,3,2,1,0,0,20,10,1,2,21,5,10,16,3,0
19:45,Wigan,Lincoln,1,2,A,0,1,A,S Stockbridge,20,13,2,3,11,9,9,4,3,2,0,0,30,20,1,3,33,5,13,20,5,0
15:00,Cambridge,AFC Wimbledon,1,0,H,0,0,D,T Reeves,10,5,2,2,9,8,7,3,3,2,0,0,30,20,0,1,15,4,10,17,5,0
15:00,Charlton,Doncaster,4,0,H,2,0,H,T Robinson,16,4,10,0,9,15,3,0,1,1,0,0,10,10,2,4,20,10,3,24,2,0
15:00,Cheltenham,Sheffield Weds,2,2,D,1,0,H,C Breakspear,15,15,6,3,15,16,4,15,2,2,0,0,20,20,1,4,30,9,19,31,4,0
15:00,Crewe,Milton Keynes Dons,1,4,A,0,1,A,A Haines,5,10,1,4,13,8,4,2,1,1,0,0,10,10,1,5,15,5,6,21,2,0
15:00,Fleetwood Town,Wycombe,3,3,D,1,2,A,A Kitchen,16,23,6,5,5,16,7,7,1,3,0,0,10,30,3,6,39,11,14,21,4,0
15:00,Gillingham,Accrington,0,0,D,0,0,D,C Pollard,20,12,7,3,13,11,6,2,1,2,0,0,10,20,0,0,32,10,8,24,3,0
15:00,Lincoln,Shrewsbury,1,1,D,1,0,H,R Madley,17,17,7,7,11,11,4,8,2,2,0,0,20,20,1,2,34,14,12,22,4,0
15:00,Oxford,Morecambe,3,1,H,1,0,H,L Swabey,15,18,5,4,7,6,6,6,0,1,0,0,0,10,1,4,33,9,12,13,1,0
15:00,Plymouth,Ipswich,2,1,H,1,1,D,R Lewis,12,8,7,4,4,18,7,4,1,4,0,0,10,40,2,3,20,11,11,22,5,0
15:00,Portsmouth,Bolton,1,0,H,0,0,D,C Hicks,9,8,4,1,8,13,3,5,0,0,0,0,0,0,0,1,17,5,8,21,0,0
15:00,Rotherham,Sunderland,5,1,H,2,1,H,D Rock,20,7,8,4,13,22,5,0,2,2,0,1,20,45,3,6,27,12,5,35,4,1
15:00,Wigan,Burton,2,0,H,1,0,H,C Brook,24,3,6,0,12,9,11,2,2,1,0,1,20,35,1,2,27,6,13,21,3,1
19:45,Charlton,Rotherham,1,1,D,0,1,A,S Oldham,11,12,7,3,10,18,3,8,3,4,0,0,30,40,1,2,23,10,11,28,7,0
19:45,Crewe,Doncaster,1,1,D,1,1,D,S Mather,4,13,2,4,12,15,6,2,0,5,0,0,0,50,2,2,17,6,8,27,5,0
19:45,Fleetwood Town,Wigan,2,3,A,1,0,H,R Joyce,10,17,2,7,10,13,1,13,3,2,0,0,30,20,1,5,27,9,14,23,5,0
19:45,Morecambe,Cambridge,0,2,A,0,1,A,R Madley,10,13,1,7,12,15,5,4,4,1,0,0,40,10,1,2,23,8,9,27,5,0
19:45,Portsmouth,Cheltenham,1,1,D,1,1,D,R Lewis,16,12,6,2,17,10,3,6,2,2,0,0,20,20,2,2,28,8,9,27,4,0
19:45,Sheffield Weds,Sunderland,3,0,H,2,0,H,C Hicks,10,14,4,5,14,9,1,3,2,0,0,0,20,0,2,3,24,9,4,23,2,0
19:45,Wycombe,Ipswich,1,4,A,1,1,D,L Swabey,20,14,6,6,7,10,11,3,2,2,0,0,20,20,2,5,34,12,14,17,4,0
20:00,Bolton,Crewe,2,0,H,0,0,D,J Bell,14,7,5,2,7,17,8,0,1,4,0,0,10,40,0,2,21,7,8,24,5,0
15:00,Accrington,Plymouth,1,4,A,0,2,A,D Rock,18,9,2,7,9,9,9,6,2,2,0,0,20,20,2,5,27,9,15,18,4,0
15:00,Burton,Charlton,0,1,A,0,1,A,T Kettle,6,7,3,3,10,6,2,10,1,3,1,1,35,55,1,1,13,6,12,16,4,2
15:00,Ipswich,Oxford,0,0,D,0,0,D,S Oldham,8,11,2,3,13,9,5,5,2,1,0,0,20,10,0,0,19,5,10,22,3,0
15:00,Milton Keynes Dons,Cambridge,4,1,H,3,0,H,S Stockbridge,16,7,8,4,8,12,3,3,1,2,0,0,10,20,3,5,23,12,6,20,3,0
15:00,Sheffield Weds,Gillingham,1,1,D,0,1,A,J Busby,22,5,9,3,8,8,7,2,1,2,0,0,10,20,1,2,27,12,9,16,3,0
15:00,Wycombe,Portsmouth,0,1,A,0,0,D,N Hair,21,12,5,4,15,10,5,2,2,1,0,0,20,10,0,1,33,9,7,25,3,0
15:00,Accrington,Sheffield Weds,2,3,A,1,3,A,P Howard,11,14,5,5,9,11,6,9,2,2,0,0,20,20,4,5,25,10,15,20,4,0
15:00,Charlton,Plymouth,2,0,H,0,0,D,P Wright,14,8,5,3,7,11,11,5,1,2,0,0,10,20,0,2,22,8,16,18,3,0
15:00,Cheltenham,Shrewsbury,2,1,H,1,1,D,O Yates,20,10,8,2,6,9,6,8,0,3,0,1,0,55,2,3,30,10,14,15,3,1
15:00,Crewe,Gillingham,2,0,H,1,0,H,A Backhouse,20,12,8,2,7,9,5,12,1,2,0,0,10,20,1,2,32,10,17,16,3,0
15:00,Doncaster,Lincoln,0,0,D,0,0,D,R Lewis,12,13,2,1,9,12,5,9,1,2,0,0,10,20,0,0,25,3,14,21,3,0
15:00,Fleetwood Town,Morecambe,1,2,A,0,1,A,D Drysdale,17,20,4,7,10,7,9,6,0,2,1,0,25,20,1,3,37,11,15,17,2,1
15:00,Milton Keynes Dons,Burton,1,0,H,0,0,D,N Hair,10,7,3,0,5,13,2,11,1,3,0,0,10,30,0,1,17,3,13,18,4,0
15:00,Portsmouth,AFC Wimbledon,2,1,H,0,1,A,T Bramall,14,14,8,6,10,9,5,6,1,1,0,0,10,10,1,3,28,14,11,19,2,0
15:00,Rotherham,Cambridge,3,1,H,2,0,H,A Davies,22,10,11,3,9,8,7,2,2,0,0,0,20,0,2,4,32,14,9,17,2,0
15:00,Sunderland,Ipswich,2,0,H,0,0,D,T Nield,10,13,2,4,11,13,6,5,4,1,0,0,40,10,0,2,23,6,11,24,5,0
15:00,Wycombe,Bolton,1,0,H,0,0,D,J Oldham,19,18,7,4,12,9,8,11,2,0,0,0,20,0,0,1,37,11,19,21,2,0
19:45,AFC Wimbledon,Crewe,3,2,H,3,1,H,C Hicks,28,11,7,3,12,7,8,4,1,3,1,0,35,30,4,5,39,10,12,19,4,1
19:45,Burton,Accrington,4,0,H,2,0,H,D Drysdale,18,8,7,2,12,13,8,1,0,2,0,0,0,20,2,4,26,9,9,25,2,0
19:45,Cambridge,Wigan,2,2,D,1,0,H,D Bourne,5,11,3,5,9,14,2,7,2,0,0,0,20,0,1,4,16,8,9,23,2,0
19:45,Gillingham,Cheltenham,0,2,A,0,1,A,J Linington,13,14,3,5,8,5,6,4,1,1,0,0,10,10,1,2,27,8,10,13,2,0
19:45,Ipswich,Rotherham,0,2,A,0,1,A,G Ward,5,11,1,3,14,12,3,5,1,3,0,0,10,30,1,2,16,4,8,26,4,0
19:45,Lincoln,Portsmouth,0,3,A,0,1,A,R Joyce,11,20,2,6,13,18,3,3,2,2,0,0,20,20,1,3,31,8,6,31,4,0
19:45,Morecambe,Charlton,2,2,D,1,2,A,A Haines,7,16,2,4,10,17,3,6,2,2,0,0,20,20,3,4,23,6,9,27,4,0
19:45,Oxford,Fleetwood Town,3,1,H,2,1,H,O Yates,14,9,4,4,6,12,3,3,1,3,0,0,10,30,3,4,23,8,6,18,4,0
19:45,Plymouth,Wycombe,0,3,A,0,0,D,A Young,27,16,4,7,6,13,7,3,2,4,0,0,20,40,0,3,43,11,10,19,6,0
19:45,Sheffield Weds,Milton Keynes Dons,2,1,H,0,0,D,R Madley,25,7,11,2,12,7,14,2,1,2,0,0,10,20,0,3,32,13,16,19,3,0
19:45,Shrewsbury,Sunderland,1,1,D,0,1,A,P Wright,10,20,3,4,8,4,6,5,0,1,1,0,25,10,1,2,30,7,11,12,1,1
20:00,Bolton,Doncaster,3,0,H,2,0,H,S Martin,20,6,5,1,6,9,14,4,1,0,0,1,10,25,2,3,26,6,18,15,1,1
15:00,AFC Wimbledon,Fleetwood Town,2,2,D,0,1,A,R Madley,9,13,3,5,9,9,1,7,1,2,0,0,10,20,1,4,22,8,8,18,3,0
15:00,Bolton,Cheltenham,2,2,D,1,2,A,R Joyce,20,11,6,7,7,10,4,4,1,1,0,0,10,10,3,4,31,13,8,17,2,0
15:00,Burton,Doncaster,2,0,H,0,0,D,P Wright,18,2,6,0,8,9,10,5,1,3,0,0,10,30,0,2,20,6,15,17,4,0
15:00,Cambridge,Sunderland,1,2,A,1,2,A,R Lewis,9,13,2,2,6,6,12,6,0,1,0,0,0,10,3,3,22,4,18,12,1,0
15:00,Gillingham,Portsmouth,0,1,A,0,0,D,D Whitestone,8,10,2,4,9,8,5,4,0,1,0,0,0,10,0,1,18,6,9,17,1,0
15:00,Morecambe,Milton Keynes Dons,0,4,A,0,2,A,R Welch,11,10,5,7,9,7,7,4,1,1,0,0,10,10,2,4,21,12,11,16,2,0
15:00,Oxford,Rotherham,0,0,D,0,0,D,S Purkiss,9,15,5,1,9,11,3,9,1,5,0,0,10,50,0,0,24,6,12,20,6,0
15:00,Plymouth,Wigan,1,2,A,1,1,D,A Woolmer,15,15,1,5,10,8,9,6,1,1,0,0,10,10,2,3,30,6,15,18,2,0
15:00,Sheffield Weds,Wycombe,2,2,D,1,1,D,D Drysdale,18,6,8,2,9,14,8,3,2,2,0,0,20,20,2,4,24,10,11,23,4,0
15:00,Shrewsbury,Charlton,1,0,H,0,0,D,T Nield,7,8,2,4,10,13,4,11,1,3,0,0,10,30,0,1,15,6,15,23,4,0
15:15,Lincoln,Accrington,0,1,A,0,0,D,C Hicks,13,15,3,5,11,17,6,9,1,3,0,0,10,30,0,1,28,8,15,28,4,0
15:00,Ipswich,Crewe,2,1,H,2,0,H,J Oldham,13,11,4,3,20,8,5,5,2,1,0,0,20,10,2,3,24,7,10,28,3,0
15:00,Accrington,Fleetwood Town,5,1,H,1,0,H,T Nield,14,6,7,1,18,14,3,3,1,2,0,1,10,45,1,6,20,8,6,32,3,1
15:00,Sunderland,Oxford,1,1,D,1,1,D,J Simpson,17,9,3,3,11,11,5,3,2,2,0,0,20,20,2,2,26,6,8,22,4,0
19:45,Accrington,AFC Wimbledon,0,2,A,0,0,D,S Mather,15,11,5,3,8,18,9,5,2,0,0,0,20,0,0,2,26,8,14,26,2,0
19:45,Charlton,Ipswich,2,0,H,1,0,H,C Sarginson,21,8,10,0,8,15,7,4,1,1,0,0,10,10,1,2,29,10,11,23,2,0
19:45,Cheltenham,Cambridge,0,5,A,0,1,A,C Pollard,6,15,1,7,12,8,6,1,2,1,0,0,20,10,1,5,21,8,7,20,3,0
19:45,Crewe,Lincoln,2,0,H,0,0,D,D Bourne,16,11,6,2,11,17,1,6,1,1,0,1,10,35,0,2,27,8,7,28,2,1
19:45,Doncaster,Oxford,1,2,A,0,1,A,J Oldham,10,12,2,4,14,8,3,4,3,0,0,0,30,0,1,3,22,6,7,22,3,0
19:45,Fleetwood Town,Bolton,3,0,H,1,0,H,S Stockbridge,8,8,4,4,14,12,1,6,2,0,0,1,20,25,1,3,16,8,7,26,2,1
19:45,Portsmouth,Sheffield Weds,0,0,D,0,0,D,S Purkiss,13,9,4,2,12,11,8,6,1,1,0,1,10,35,0,0,22,6,14,23,2,1
19:45,Rotherham,Gillingham,5,1,H,2,1,H,R Joyce,28,1,7,1,9,16,8,1,0,0,0,1,0,25,3,6,29,8,9,25,0,1
19:45,Sunderland,Morecambe,5,0,H,2,0,H,O Yates,17,9,8,2,7,5,11,1,0,1,0,0,0,10,2,5,26,10,12,12,1,0
19:45,Wycombe,Burton,2,1,H,2,0,H,J Smith,16,13,4,2,4,10,6,1,1,3,0,0,10,30,2,3,29,6,7,14,4,0
19:45,Milton Keynes Dons,Plymouth,1,1,D,1,0,H,S Barrott,9,12,3,2,9,14,2,7,0,2,0,0,0,20,1,2,21,5,9,23,2,0
19:45,Wigan,Shrewsbury,2,1,H,1,1,D,D Rock,12,11,6,2,13,14,4,1,1,2,0,0,10,20,2,3,23,8,5,27,3,0
15:00,Accrington,Bolton,1,0,H,1,0,H,A Young,18,8,6,2,8,13,7,2,3,0,0,0,30,0,1,1,26,8,9,21,3,0
15:00,Charlton,Cambridge,2,0,H,1,0,H,B Speedie,12,12,4,4,14,12,4,3,5,4,0,0,50,40,1,2,24,8,7,26,9,0
15:00,Cheltenham,Lincoln,2,2,D,1,0,H,T Nield,14,17,7,7,9,12,6,8,5,2,0,0,50,20,1,4,31,14,14,21,7,0
15:00,Crewe,Sheffield Weds,0,2,A,0,1,A,L Swabey,7,13,4,5,8,8,4,5,1,2,0,0,10,20,1,2,20,9,9,16,3,0
15:00,Doncaster,Shrewsbury,1,0,H,0,0,D,C Pollard,10,12,3,2,10,5,8,5,2,1,0,0,20,10,0,1,22,5,13,15,3,0
15:00,Fleetwood Town,Gillingham,2,1,H,1,0,H,S Martin,14,7,4,3,13,16,9,6,1,2,0,0,10,20,1,3,21,7,15,29,3,0
15:00,Milton Keynes Dons,Oxford,1,2,A,1,0,H,T Reeves,12,12,4,4,10,14,3,6,1,3,0,1,10,55,1,3,24,8,9,24,4,1
15:00,Portsmouth,Morecambe,2,0,H,1,0,H,C Breakspear,17,14,8,4,14,12,5,3,1,3,0,0,10,30,1,2,31,12,8,26,4,0
15:00,Rotherham,Burton,3,1,H,1,1,D,S Allison,14,16,5,2,2,8,5,8,0,1,0,0,0,10,2,4,30,7,13,10,1,0
15:00,Sunderland,Plymouth,2,1,H,2,0,H,S Oldham,17,8,7,4,6,6,8,3,4,2,0,0,40,20,2,3,25,11,11,12,6,0
15:00,Wigan,Ipswich,1,1,D,1,0,H,T Kettle,7,10,3,3,11,13,7,4,2,2,0,0,20,20,1,2,17,6,11,24,4,0
15:00,Wycombe,AFC Wimbledon,2,2,D,0,1,A,W Finnie,18,14,7,6,14,11,9,4,1,4,0,0,10,40,1,4,32,13,13,25,5,0
15:00,Cambridge,Rotherham,0,1,A,0,0,D,T Kettle,6,12,1,6,9,16,3,4,2,1,0,0,20,10,0,1,18,7,7,25,3,0
15:00,Ipswich,Sunderland,1,1,D,1,0,H,T Bramall,16,5,2,2,6,8,7,3,1,3,0,0,10,30,1,2,21,4,10,14,4,0
15:00,Morecambe,Fleetwood Town,0,0,D,0,0,D,C Pollard,9,9,1,4,14,7,4,7,1,1,0,0,10,10,0,0,18,5,11,21,2,0
15:00,Oxford,Wigan,2,3,A,1,2,A,J Bell,14,8,2,4,10,19,6,7,2,5,0,0,20,50,3,5,22,6,13,29,7,0
15:00,Plymouth,Charlton,1,0,H,1,0,H,C Hicks,12,8,5,3,14,14,1,3,1,1,0,0,10,10,1,1,20,8,4,28,2,0
15:00,Shrewsbury,Cheltenham,3,1,H,1,1,D,A Kitchen,9,26,5,9,8,5,3,5,0,3,1,0,25,30,2,4,35,14,8,13,3,1
15:00,Accrington,Rotherham,1,0,H,0,0,D,A Kitchen,14,10,6,4,12,14,6,9,1,1,0,0,10,10,0,1,24,10,15,26,2,0
15:00,Cheltenham,Plymouth,0,2,A,0,1,A,T Reeves,9,10,2,4,14,10,6,0,1,0,0,0,10,0,1,2,19,6,6,24,1,0
15:00,Fleetwood Town,Shrewsbury,0,3,A,0,0,D,A Backhouse,5,11,2,7,5,12,2,4,0,2,0,0,0,20,0,3,16,9,6,17,2,0
15:00,Lincoln,Milton Keynes Dons,2,3,A,2,0,H,C Boyeson,7,14,2,9,12,13,5,3,4,2,0,0,40,20,2,5,21,11,8,25,6,0
12:30,Doncaster,Sunderland,0,3,A,0,2,A,R Madley,6,20,3,5,11,8,2,6,1,1,0,0,10,10,2,3,26,8,8,19,2,0
19:45,Ipswich,Wycombe,1,0,H,1,0,H,S Barrott,7,12,3,1,9,8,2,7,3,1,0,0,30,10,1,1,19,4,9,17,4,0
19:45,Morecambe,Crewe,1,2,A,1,0,H,S Stockbridge,16,7,3,2,10,9,7,5,0,2,0,0,0,20,1,3,23,5,12,19,2,0
19:45,Oxford,AFC Wimbledon,3,0,H,2,0,H,T Kettle,13,5,7,3,12,11,7,1,2,3,0,0,20,30,2,3,18,10,8,23,5,0
19:45,Shrewsbury,Accrington,0,0,D,0,0,D,N Hair,9,23,3,4,11,11,3,8,2,2,0,0,20,20,0,0,32,7,11,22,4,0
19:45,Sunderland,Sheffield Weds,5,0,H,3,0,H,B Toner,14,9,9,3,9,9,8,5,2,1,0,0,20,10,3,5,23,12,13,18,3,0
15:00,Burton,Crewe,4,1,H,3,1,H,P Wright,20,10,9,2,12,3,3,4,0,2,0,0,0,20,4,5,30,11,7,15,2,0
15:00,Charlton,Wycombe,0,1,A,0,1,A,P Howard,13,10,2,4,10,16,1,4,2,4,0,0,20,40,1,1,23,6,5,26,6,0
15:00,Milton Keynes Dons,Gillingham,0,0,D,0,0,D,C Breakspear,17,6,3,1,10,16,6,2,1,4,0,0,10,40,0,0,23,4,8,26,5,0
15:00,Oxford,Cheltenham,1,1,D,0,0,D,C Brook,16,8,4,4,8,11,9,3,1,5,0,0,10,50,0,2,24,8,12,19,6,0
15:00,Rotherham,Bolton,2,1,H,1,1,D,G Eltringham,15,12,5,5,16,9,11,3,2,3,0,0,20,30,2,3,27,10,14,25,5,0
15:00,Morecambe,Doncaster,4,3,H,0,3,A,J Bell,24,8,8,4,9,13,8,3,1,2,0,0,10,20,3,7,32,12,11,22,3,0
15:00,Shrewsbury,Sheffield Weds,1,0,H,1,0,H,M Edwards,11,14,6,5,11,7,4,8,2,2,0,0,20,20,1,1,25,11,12,18,4,0
15:00,Cambridge,Portsmouth,0,0,D,0,0,D,J Smith,10,13,6,2,12,18,1,11,2,3,1,0,45,30,0,0,23,8,12,30,5,1
12:30,Wycombe,Sunderland,3,3,D,2,2,D,C Breakspear,15,21,8,7,12,10,3,10,2,1,0,0,20,10,4,6,36,15,13,22,3,0
15:00,Accrington,Milton Keynes Dons,1,1,D,1,1,D,W Finnie,9,23,3,7,10,12,2,14,1,1,1,0,35,10,2,2,32,10,16,22,2,1
15:00,Cheltenham,Burton,1,1,D,1,0,H,D Rock,16,7,4,3,6,10,8,2,1,2,0,0,10,20,1,2,23,7,10,16,3,0
15:00,Doncaster,Fleetwood Town,0,1,A,0,0,D,D Bond,6,15,2,6,14,4,3,4,2,2,0,0,20,20,0,1,21,8,7,18,4,0
15:00,Gillingham,Ipswich,0,4,A,0,3,A,A Young,6,15,0,5,11,10,5,5,1,1,1,0,35,10,3,4,21,5,10,21,2,1
15:00,Lincoln,Oxford,2,0,H,1,0,H,S Stockbridge,10,14,4,3,15,5,4,2,0,0,0,1,0,25,1,2,24,7,6,20,0,1
19:45,Milton Keynes Dons,AFC Wimbledon,1,0,H,1,0,H,A Backhouse,22,7,5,1,5,10,3,3,0,0,0,1,0,25,1,1,29,6,6,15,0,1
19:45,Sunderland,Lincoln,1,3,A,0,1,A,J Simpson,11,8,5,4,14,14,8,5,2,7,1,0,45,70,1,4,19,9,13,28,9,1
20:00,Bolton,Wycombe,0,2,A,0,1,A,P Wright,15,8,3,5,7,15,7,5,0,4,0,0,0,40,1,2,23,8,12,22,4,0
19:45,Crewe,Charlton,2,1,H,2,0,H,R Lewis,9,11,4,6,11,20,6,3,2,3,0,0,20,30,2,3,20,10,9,31,5,0
15:00,Accrington,Sunderland,1,1,D,0,0,D,J Bell,20,13,3,4,11,10,4,12,1,0,1,0,35,0,0,2,33,7,16,21,1,1
15:00,AFC Wimbledon,Morecambe,0,0,D,0,0,D,B Speedie,15,7,3,1,15,10,7,3,2,2,0,0,20,20,0,0,22,4,10,25,4,0
15:00,Bolton,Ipswich,2,0,H,0,0,D,R Madley,8,14,4,3,5,7,5,12,2,3,0,0,20,30,0,2,22,7,17,12,5,0
15:00,Cheltenham,Charlton,1,1,D,1,0,H,S Stockbridge,14,10,7,5,17,11,4,5,3,2,0,0,30,20,1,2,24,12,9,28,5,0
15:00,Crewe,Shrewsbury,0,0,D,0,0,D,G Ward,9,12,1,3,4,13,0,9,2,0,0,0,20,0,0,0,21,4,9,17,2,0
15:00,Doncaster,Wigan,1,2,A,0,1,A,A Young,7,13,2,5,10,9,1,6,3,1,0,0,30,10,1,3,20,7,7,19,4,0
15:00,Fleetwood Town,Rotherham,1,0,H,0,0,D,R Lewis,9,16,4,5,13,15,4,8,2,0,0,0,20,0,0,1,25,9,12,28,2,0
15:00,Gillingham,Burton,1,3,A,1,0,H,T Bramall,13,7,5,4,9,13,6,2,2,1,0,0,20,10,1,4,20,9,8,22,3,0
15:00,Lincoln,Cambridge,0,1,A,0,0,D,A Kitchen,16,13,7,5,10,6,8,1,0,1,0,0,0,10,0,1,29,12,9,16,1,0
15:00,Portsmouth,Milton Keynes Dons,1,2,A,0,2,A,S Oldham,22,14,6,6,10,9,5,1,2,2,0,0,20,20,2,3,36,12,6,19,4,0
15:00,Sheffield Weds,Plymouth,4,2,H,2,0,H,C Pollard,22,3,7,2,10,9,8,3,2,1,0,0,20,10,2,6,25,9,11,19,3,0
15:00,Wycombe,Oxford,2,0,H,1,0,H,A Backhouse,9,15,5,7,9,8,2,6,2,2,0,0,20,20,1,2,24,12,8,17,4,0
19:45,AFC Wimbledon,Portsmouth,0,0,D,0,0,D,J Oldham,12,12,1,5,16,11,6,8,2,2,0,0,20,20,0,0,24,6,14,27,4,0
19:45,Cambridge,Doncaster,3,1,H,1,0,H,C Sarginson,8,11,5,5,7,10,1,4,2,1,0,0,20,10,1,4,19,10,5,17,3,0
19:45,Morecambe,Wigan,1,2,A,1,1,D,S Barrott,13,11,5,4,8,12,1,4,1,1,0,0,10,10,2,3,24,9,5,20,2,0
15:00,Burton,AFC Wimbledon,1,1,D,0,0,D,A Kitchen,21,12,6,3,11,4,8,1,2,0,0,0,20,0,0,2,33,9,9,15,2,0
15:00,Cambridge,Crewe,1,0,H,1,0,H,S Allison,11,14,2,3,16,13,5,6,3,2,0,0,30,20,1,1,25,5,11,29,5,0
15:00,Charlton,Fleetwood Town,2,0,H,0,0,D,B Huxtable,13,9,5,2,20,10,4,6,2,1,0,0,20,10,0,2,22,7,10,30,3,0
15:00,Ipswich,Accrington,2,1,H,1,1,D,G Eltringham,11,13,4,4,13,11,1,6,3,3,0,0,30,30,2,3,24,8,7,24,6,0
15:00,Milton Keynes Dons,Doncaster,0,1,A,0,1,A,D Drysdale,25,7,6,3,3,13,6,5,1,3,0,0,10,30,1,1,32,9,11,16,4,0
15:00,Morecambe,Wycombe,3,2,H,1,1,D,B Toner,19,17,6,4,9,20,5,3,2,2,0,0,20,20,2,5,36,10,8,29,4,0
15:00,Oxford,Sheffield Weds,3,2,H,1,1,D,W Finnie,17,18,8,5,11,9,8,4,1,2,0,0,10,20,2,5,35,13,12,20,3,0
15:00,Plymouth,Lincoln,1,2,A,1,0,H,N Hair,18,18,8,5,10,12,6,3,1,4,0,0,10,40,1,3,36,13,9,22,5,0
15:00,Rotherham,Cheltenham,1,0,H,1,0,H,O Langford,10,5,2,2,11,20,6,2,0,4,0,0,0,40,1,1,15,4,8,31,4,0
15:00,Shrewsbury,Bolton,0,1,A,0,0,D,C Breakspear,21,10,6,3,16,8,6,4,2,1,0,0,20,10,0,1,31,9,10,24,3,0
15:00,Sunderland,Portsmouth,1,0,H,1,0,H,D Rock,8,11,4,2,14,16,3,4,1,2,0,0,10,20,1,1,19,6,7,30,3,0
15:00,Wigan,Gillingham,3,2,H,2,0,H,C Boyeson,15,7,9,2,10,10,5,1,1,1,0,0,10,10,2,5,22,11,6,20,2,0
19:45,AFC Wimbledon,Ipswich,0,2,A,0,0,D,L Swabey,12,8,4,2,7,10,1,9,1,1,0,1,10,35,0,2,20,6,10,17,2,1
19:45,Burton,Milton Keynes Dons,0,1,A,0,0,D,D Handley,9,21,4,7,11,7,4,6,2,0,0,0,20,0,0,1,30,11,10,18,2,0
19:45,Fleetwood Town,Plymouth,3,3,D,1,1,D,M Edwards,23,9,11,6,12,12,4,2,1,1,0,0,10,10,2,6,32,17,6,24,2,0
19:45,Gillingham,Shrewsbury,0,0,D,0,0,D,B Huxtable,14,4,3,1,11,11,7,2,3,1,0,0,30,10,0,0,18,4,9,22,4,0
15:00,Accrington,Morecambe,2,2,D,2,2,D,S Purkiss,33,4,7,4,10,8,12,4,2,2,0,0,20,20,4,4,37,11,16,18,4,0
15:00,AFC Wimbledon,Shrewsbury,1,1,D,1,0,H,C Boyeson,13,9,5,3,14,12,1,6,3,2,0,0,30,20,1,2,22,8,7,26,5,0
15:00,Bolton,Sunderland,6,0,H,2,0,H,S Martin,15,7,7,2,12,14,2,1,1,1,0,0,10,10,2,6,22,9,3,26,2,0
15:00,Cheltenham,Wigan,0,0,D,0,0,D,P Howard,8,8,1,2,14,15,2,3,0,2,1,0,25,20,0,0,16,3,5,29,2,1
15:00,Crewe,Rotherham,0,2,A,0,1,A,B Speedie,6,15,2,1,12,11,0,6,2,2,1,0,45,20,1,2,21,3,6,23,4,1
15:00,Doncaster,Plymouth,1,3,A,1,1,D,M Coy,17,14,5,5,11,9,4,6,2,1,0,0,20,10,2,4,31,10,10,20,3,0
15:00,Fleetwood Town,Cambridge,1,1,D,0,0,D,R Welch,18,8,3,3,10,10,8,5,1,2,0,0,10,20,0,2,26,6,13,20,3,0
15:00,Gillingham,Oxford,2,7,A,0,3,A,R Madley,14,15,9,8,16,10,7,1,3,0,0,0,30,0,3,9,29,17,8,26,3,0
15:00,Lincoln,Burton,1,2,A,0,0,D,C Breakspear,12,19,2,8,11,19,10,5,0,2,0,0,0,20,0,3,31,10,15,30,2,0
15:00,Sheffield Weds,Ipswich,1,0,H,1,0,H,D Bond,11,10,4,0,9,7,5,5,1,0,0,0,10,0,1,1,21,4,10,16,1,0
15:00,Wycombe,Milton Keynes Dons,0,1,A,0,1,A,R Lewis,9,8,3,5,13,10,3,4,2,6,0,0,20,60,1,1,17,8,7,23,8,0
19:45,Portsmouth,Charlton,1,2,A,0,1,A,N Hair,15,15,2,3,5,14,4,8,1,4,0,0,10,40,1,3,30,5,12,19,5,0
19:45,AFC Wimbledon,Cheltenham,2,2,D,1,2,A,S Purkiss,15,10,6,4,7,13,5,2,3,3,0,0,30,30,3,4,25,10,7,20,6,0
19:45,Doncaster,Rotherham,0,5,A,0,2,A,S Oldham,3,15,1,7,8,11,3,7,1,0,0,0,10,0,2,5,18,8,10,19,1,0
19:45,Gillingham,Crewe,1,0,H,1,0,H,D Drysdale,9,16,2,4,8,7,8,9,2,0,0,0,20,0,1,1,25,6,17,15,2,0
19:45,Sheffield Weds,Morecambe,2,0,H,0,0,D,O Yates,19,9,5,4,8,8,11,3,1,1,0,0,10,10,0,2,28,9,14,16,2,0
19:45,Wigan,Oxford,1,1,D,1,1,D,A Kitchen,12,5,3,1,13,14,5,1,2,4,0,0,20,40,2,2,17,4,6,27,6,0
20:00,Bolton,Cambridge,2,0,H,1,0,H,A Haines,17,9,6,0,10,7,8,5,1,1,0,0,10,10,1,2,26,6,13,17,2,0
15:00,Burton,Sheffield Weds,0,2,A,0,1,A,A Young,13,8,6,4,10,17,6,8,3,1,0,0,30,10,1,2,21,10,14,27,4,0
15:00,Charlton,AFC Wimbledon,3,2,H,2,2,D,C Pollard,12,13,5,3,11,11,11,6,4,0,0,0,40,0,4,5,25,8,17,22,4,0
15:00,Ipswich,Gillingham,1,0,H,0,0,D,S Martin,11,13,2,1,13,6,4,4,0,1,0,0,0,10,0,1,24,3,8,19,1,0
15:00,Milton Keynes Dons,Lincoln,2,1,H,1,1,D,B Huxtable,11,8,7,4,12,10,6,4,2,0,0,0,20,0,2,3,19,11,10,22,2,0
15:00,Morecambe,Bolton,1,1,D,0,0,D,R Joyce,13,9,7,1,10,11,5,1,1,1,0,1,10,35,0,2,22,8,6,21,2,1
15:00,Oxford,Portsmouth,3,2,H,1,1,D,S Barrott,28,3,10,3,12,14,14,2,4,7,0,1,40,95,2,5,31,13,16,26,11,1
15:00,Rotherham,Accrington,1,0,H,0,0,D,A Woolmer,11,14,4,7,14,14,5,2,3,4,1,0,55,40,0,1,25,11,7,28,7,1
15:00,Shrewsbury,Fleetwood Town,1,1,D,0,1,A,J Bell,9,11,4,3,8,11,7,3,1,2,0,1,10,45,1,2,20,7,10,19,3,1
15:00,Sunderland,Doncaster,1,2,A,0,2,A,W Finnie,21,10,10,5,7,10,10,2,1,0,0,0,10,0,2,3,31,15,12,17,1,0
19:45,Accrington,Oxford,2,0,H,1,0,H,M Coy,15,15,7,3,11,12,2,4,1,2,0,0,10,20,1,2,30,10,6,23,3,0
19:45,AFC Wimbledon,Rotherham,0,1,A,0,0,D,C Breakspear,3,20,1,4,14,9,0,8,2,1,0,0,20,10,0,1,23,5,8,23,3,0
19:45,Cheltenham,Sunderland,2,1,H,0,1,A,D Drysdale,7,10,3,5,11,11,3,5,1,3,0,0,10,30,1,3,17,8,8,22,4,0
19:45,Crewe,Plymouth,1,4,A,1,0,H,J Busby,7,18,2,9,7,13,3,7,1,2,0,0,10,20,1,5,25,11,10,20,3,0
19:45,Doncaster,Ipswich,0,1,A,0,1,A,O Yates,3,17,0,7,7,7,7,6,0,2,0,0,0,20,1,1,20,7,13,14,2,0
19:45,Fleetwood Town,Milton Keynes Dons,1,1,D,0,1,A,C Sarginson,7,10,2,3,20,10,3,2,3,2,0,0,30,20,1,2,17,5,5,30,5,0
19:45,Gillingham,Cambridge,1,0,H,0,0,D,J Bell,13,7,5,1,12,12,4,0,2,0,0,0,20,0,0,1,20,6,4,24,2,0
19:45,Lincoln,Morecambe,2,1,H,2,0,H,A Backhouse,9,17,5,3,7,10,1,3,2,1,0,0,20,10,2,3,26,8,4,17,3,0
19:45,Portsmouth,Burton,2,1,H,2,0,H,C Hicks,22,10,6,4,12,20,9,4,2,4,0,0,20,40,2,3,32,10,13,32,6,0
19:45,Sheffield Weds,Wigan,1,0,H,0,0,D,T Robinson,11,7,4,1,14,9,6,0,2,1,0,0,20,10,0,1,18,5,6,23,3,0
19:45,Wycombe,Shrewsbury,0,0,D,0,0,D,S Purkiss,26,2,10,0,11,10,8,1,1,3,0,0,10,30,0,0,28,10,9,21,4,0
20:00,Bolton,Charlton,2,1,H,1,0,H,B Toner,7,9,3,3,14,16,1,3,3,4,0,0,30,40,1,3,16,6,4,30,7,0
15:00,Accrington,Crewe,4,1,H,1,0,H,S Barrott,15,10,8,4,13,15,3,4,2,3,0,0,20,30,1,5,25,12,7,28,5,0
15:00,AFC Wimbledon,Sunderland,1,1,D,1,1,D,S Mather,11,8,6,1,22,18,9,5,4,7,1,0,65,70,2,2,19,7,14,40,11,1
15:00,Burton,Cambridge,2,2,D,1,1,D,M Edwards,14,9,3,2,7,11,6,4,1,1,0,0,10,10,2,4,23,5,10,18,2,0
15:00,Cheltenham,Fleetwood Town,2,0,H,2,0,H,R Madley,11,7,3,1,7,7,10,0,1,2,0,0,10,20,2,2,18,4,10,14,3,0
15:00,Lincoln,Wycombe,1,1,D,1,0,H,O Yates,7,28,4,6,14,16,5,2,5,0,0,1,50,25,1,2,35,10,7,30,5,1
15:00,Milton Keynes Dons,Ipswich,0,0,D,0,0,D,O Langford,7,9,4,2,9,14,7,6,3,3,0,0,30,30,0,0,16,6,13,23,6,0
15:00,Morecambe,Gillingham,1,1,D,0,0,D,P Wright,22,8,5,3,9,11,4,2,0,2,0,0,0,20,0,2,30,8,6,20,2,0
15:00,Oxford,Bolton,2,3,A,2,2,D,G Ward,13,6,5,5,9,10,10,1,3,1,0,0,30,10,4,5,19,10,11,19,4,0
15:00,Plymouth,Shrewsbury,1,0,H,0,0,D,J Oldham,14,6,4,2,6,21,8,6,3,1,0,0,30,10,0,1,20,6,14,27,4,0
15:00,Portsmouth,Doncaster,4,0,H,0,0,D,T Reeves,15,8,9,3,12,13,3,1,1,0,0,0,10,0,0,4,23,12,4,25,1,0
15:00,Wigan,Charlton,2,1,H,1,1,D,T Nield,8,6,3,1,9,18,6,2,1,3,0,0,10,30,2,3,14,4,8,27,4,0
12:00,Sheffield Weds,Rotherham,0,2,A,0,0,D,D Drysdale,15,9,6,2,12,6,6,5,2,0,0,0,20,0,0,2,24,8,11,18,2,0
19:45,Burton,Bolton,3,1,H,3,0,H,S Oldham,10,18,5,9,14,7,8,4,1,1,0,0,10,10,3,4,28,14,12,21,2,0
19:45,Lincoln,Doncaster,0,1,A,0,0,D,B Speedie,14,8,5,1,10,13,9,1,0,1,1,0,25,10,0,1,22,6,10,23,1,1
19:45,Wigan,Crewe,2,0,H,0,0,D,T Reeves,20,6,9,0,17,16,3,1,2,1,0,0,20,10,0,2,26,9,4,33,3,0
19:45,Rotherham,Wigan,1,1,D,0,1,A,J Simpson,5,3,2,1,16,21,6,1,2,4,0,0,20,40,1,2,8,3,7,37,6,0
15:00,Bolton,AFC Wimbledon,4,0,H,1,0,H,R Welch,17,6,4,1,8,11,6,2,1,1,0,0,10,10,1,4,23,5,8,19,2,0
15:00,Cambridge,Accrington,2,0,H,0,0,D,L Swabey,8,18,4,3,8,10,5,10,0,1,0,0,0,10,0,2,26,7,15,18,1,0
15:00,Charlton,Oxford,0,4,A,0,2,A,C Boyeson,6,12,2,7,8,14,4,8,6,4,1,0,85,40,2,4,18,9,12,22,10,1
15:00,Doncaster,Sheffield Weds,1,3,A,1,0,H,C Hicks,6,14,4,5,9,9,0,9,1,1,0,0,10,10,1,4,20,9,9,18,2,0
15:00,Gillingham,Plymouth,0,2,A,0,0,D,P Howard,2,22,0,5,9,12,2,2,1,1,0,0,10,10,0,2,24,5,4,21,2,0
15:00,Ipswich,Burton,3,0,H,1,0,H,C Brook,17,10,6,4,13,9,5,9,1,2,0,0,10,20,1,3,27,10,14,22,3,0
15:00,Sunderland,Milton Keynes Dons,1,2,A,0,0,D,O Yates,8,6,1,5,10,13,8,5,1,2,0,0,10,20,0,3,14,6,13,23,3,0
15:00,Wycombe,Cheltenham,5,5,D,3,1,H,N Hair,10,11,6,5,17,8,2,4,3,1,0,0,30,10,4,10,21,11,6,25,4,0
19:45,Cambridge,Plymouth,2,0,H,2,0,H,R Madley,14,9,8,1,6,11,8,7,2,2,0,0,20,20,2,2,23,9,15,17,4,0
19:45,Charlton,Milton Keynes Dons,0,2,A,0,1,A,S Purkiss,7,9,0,3,17,6,4,3,1,0,0,0,10,0,1,2,16,3,7,23,1,0
19:45,Crewe,Oxford,0,1,A,0,0,D,S Oldham,10,19,1,2,11,11,4,8,2,2,0,0,20,20,0,1,29,3,12,22,4,0
19:45,Doncaster,Accrington,2,0,H,0,0,D,A Haines,11,24,3,9,9,8,3,6,0,2,0,0,0,20,0,2,35,12,9,17,2,0
19:45,Gillingham,AFC Wimbledon,0,0,D,0,0,D,C Sarginson,20,11,4,2,9,4,7,1,2,1,0,0,20,10,0,0,31,6,8,13,3,0
19:45,Ipswich,Cheltenham,0,0,D,0,0,D,A Davies,17,6,4,1,9,11,8,1,1,4,0,0,10,40,0,0,23,5,9,20,5,0
19:45,Rotherham,Morecambe,2,0,H,2,0,H,S Mather,20,17,4,7,10,15,4,8,1,1,0,0,10,10,2,2,37,11,12,25,2,0
19:45,Shrewsbury,Portsmouth,1,2,A,1,1,D,S Stockbridge,8,15,1,6,9,12,7,7,0,1,1,0,25,10,2,3,23,7,14,21,1,1
19:45,Sunderland,Burton,1,1,D,0,0,D,O Yates,21,11,7,6,9,14,9,4,1,2,0,0,10,20,0,2,32,13,13,23,3,0
19:45,Wycombe,Wigan,1,3,A,1,0,H,T Bramall,10,11,3,5,9,16,1,7,0,1,0,0,0,10,1,4,21,8,8,25,1,0
20:00,Bolton,Lincoln,3,1,H,0,0,D,S Allison,15,8,5,3,16,9,5,6,3,0,0,0,30,0,0,4,23,8,11,25,3,0
15:00,Accrington,Wycombe,3,2,H,1,2,A,R Madley,13,10,5,3,10,15,3,4,2,3,1,0,45,30,3,5,23,8,7,25,5,1
15:00,AFC Wimbledon,Doncaster,2,2,D,1,0,H,R Lewis,14,8,3,3,14,16,8,0,2,3,0,0,20,30,1,4,22,6,8,30,5,0
15:00,Burton,Shrewsbury,0,2,A,0,1,A,B Speedie,12,7,2,3,14,6,11,4,0,0,0,0,0,0,1,2,19,5,15,20,0,0
15:00,Cheltenham,Crewe,1,2,A,0,1,A,A Backhouse,14,6,4,2,17,12,8,7,2,2,0,0,20,20,1,3,20,6,15,29,4,0
15:00,Lincoln,Gillingham,0,2,A,0,0,D,R Joyce,10,10,2,4,7,17,3,3,2,4,0,0,20,40,0,2,20,6,6,24,6,0
15:00,Milton Keynes Dons,Bolton,2,0,H,1,0,H,S Stockbridge,10,7,6,1,8,15,3,7,0,1,0,0,0,10,1,2,17,7,10,23,1,0
15:00,Morecambe,Ipswich,1,1,D,0,0,D,M Donohue,4,22,1,8,5,10,0,12,0,2,0,0,0,20,0,2,26,9,12,15,2,0
15:00,Oxford,Cambridge,4,2,H,1,1,D,C Breakspear,17,8,5,5,10,9,7,1,2,3,0,0,20,30,2,6,25,10,8,19,5,0
15:00,Plymouth,Rotherham,0,1,A,0,0,D,W Finnie,16,15,6,5,8,12,6,4,2,2,0,0,20,20,0,1,31,11,10,20,4,0
15:00,Portsmouth,Fleetwood Town,3,3,D,1,3,A,A Young,23,5,6,4,10,13,8,2,1,3,0,0,10,30,4,6,28,10,10,23,4,0
15:00,Sheffield Weds,Charlton,2,0,H,2,0,H,O Langford,10,4,3,1,12,14,9,4,3,2,0,0,30,20,2,2,14,4,13,26,5,0
15:00,Wigan,Sunderland,0,3,A,0,2,A,S Purkiss,6,13,3,4,16,17,2,6,4,6,0,0,40,60,2,3,19,7,8,33,10,0
19:45,Portsmouth,Oxford,3,2,H,2,1,H,S Allison,9,13,5,3,12,14,3,4,1,1,0,0,10,10,3,5,22,8,7,26,2,0
19:45,Sheffield Weds,Burton,5,2,H,2,1,H,S Barrott,19,12,6,3,11,9,8,1,2,2,0,0,20,20,3,7,31,9,9,20,4,0
19:45,Shrewsbury,Rotherham,0,0,D,0,0,D,C Brook,14,14,5,2,13,6,6,7,1,0,0,0,10,0,0,0,28,7,13,19,1,0
19:45,Wigan,Fleetwood Town,2,0,H,2,0,H,M Coy,20,6,5,2,11,11,9,1,3,0,1,1,55,25,2,2,26,7,10,22,3,2
19:45,Wycombe,Cambridge,3,0,H,2,0,H,J Oldham,14,9,4,3,13,5,5,2,2,1,0,0,20,10,2,3,23,7,7,18,3,0
15:00,Cambridge,Shrewsbury,0,0,D,0,0,D,N Hair,5,21,0,4,6,13,3,11,1,2,0,0,10,20,0,0,26,4,14,19,3,0
15:00,Charlton,Sunderland,0,0,D,0,0,D,A Backhouse,8,17,0,8,10,16,1,9,4,1,0,0,40,10,0,0,25,8,10,26,5,0
15:00,Cheltenham,Doncaster,4,0,H,2,0,H,P Wright,21,7,6,2,11,14,4,1,3,1,0,1,30,35,2,4,28,8,5,25,4,1
15:00,Crewe,Wycombe,1,3,A,0,1,A,A Haines,9,16,2,5,7,13,5,1,2,1,0,0,20,10,1,4,25,7,6,20,3,0
15:00,Fleetwood Town,Ipswich,0,2,A,0,0,D,A Kitchen,6,11,3,4,9,8,3,4,1,2,0,0,10,20,0,2,17,7,7,17,3,0
15:00,Gillingham,Bolton,0,3,A,0,1,A,C Hicks,8,19,1,9,9,8,7,4,0,1,1,0,25,10,1,3,27,10,11,17,1,1
15:00,Lincoln,Sheffield Weds,3,1,H,1,1,D,M Coy,14,15,9,1,12,8,8,7,2,1,0,0,20,10,2,4,29,10,15,20,3,0
15:00,Oxford,Burton,4,1,H,4,1,H,S Purkiss,24,16,9,7,7,9,10,7,0,1,0,0,0,10,5,5,40,16,17,16,1,0
15:00,Plymouth,Morecambe,2,0,H,2,0,H,A Young,11,9,4,4,5,10,7,3,0,2,0,0,0,20,2,2,20,8,10,15,2,0
15:00,Portsmouth,Accrington,4,0,H,2,0,H,C Brook,11,25,4,6,12,8,6,9,2,2,1,0,45,20,2,4,36,10,15,20,4,1
15:00,Rotherham,Milton Keynes Dons,1,2,A,1,0,H,M Edwards,16,4,4,3,17,9,4,3,1,2,0,1,10,45,1,3,20,7,7,26,3,1
15:00,Wigan,AFC Wimbledon,1,0,H,1,0,H,O Langford,22,8,9,3,14,15,9,2,2,0,0,0,20,0,1,1,30,12,11,29,2,0
19:45,Crewe,Portsmouth,1,3,A,0,2,A,A Kitchen,17,17,4,12,13,11,7,5,1,2,0,0,10,20,2,4,34,16,12,24,3,0
19:45,Ipswich,Lincoln,2,0,H,2,0,H,T Reeves,17,4,3,1,12,10,9,3,1,3,0,0,10,30,2,2,21,4,12,22,4,0
19:45,Milton Keynes Dons,Cheltenham,3,1,H,2,0,H,C Hicks,9,9,6,4,13,9,3,4,0,1,0,0,0,10,2,4,18,10,7,22,1,0
19:45,Plymouth,AFC Wimbledon,2,0,H,1,0,H,S Allison,9,10,2,2,8,9,6,6,2,0,0,0,20,0,1,2,19,4,12,17,2,0
19:45,Sunderland,Fleetwood Town,3,1,H,0,1,A,S Barrott,14,11,7,5,13,13,3,2,2,0,0,1,20,25,1,4,25,12,5,26,2,1
20:00,Bolton,Morecambe,1,1,D,0,1,A,C Sarginson,25,4,4,3,8,14,13,1,0,4,0,0,0,40,1,2,29,7,14,22,4,0
15:00,Accrington,Charlton,2,1,H,2,1,H,S Mather,17,5,6,3,16,19,2,6,3,3,1,0,55,30,3,3,22,9,8,35,6,1
15:00,AFC Wimbledon,Lincoln,0,2,A,0,1,A,C Brook,13,7,5,5,17,13,10,2,4,3,0,1,40,55,1,2,20,10,12,30,7,1
15:00,Bolton,Plymouth,0,1,A,0,1,A,R Lewis,14,9,5,6,11,7,6,5,0,0,0,0,0,0,1,1,23,11,11,18,0,0
15:00,Burton,Fleetwood Town,3,2,H,0,1,A,O Langford,22,10,6,5,9,8,10,5,1,2,0,0,10,20,1,5,32,11,15,17,3,0
15:00,Doncaster,Gillingham,0,1,A,0,1,A,A Backhouse,15,8,4,3,10,8,6,2,1,0,0,0,10,0,1,1,23,7,8,18,1,0
15:00,Ipswich,Portsmouth,0,0,D,0,0,D,C Sarginson,14,6,3,1,12,8,11,3,2,2,0,0,20,20,0,0,20,4,14,20,4,0
15:00,Milton Keynes Dons,Wigan,1,1,D,0,0,D,R Madley,5,6,2,1,11,15,6,4,2,3,0,0,20,30,0,2,11,3,10,26,5,0
15:00,Morecambe,Cheltenham,1,3,A,0,1,A,A Kitchen,22,18,8,9,3,6,6,6,0,1,0,0,0,10,1,4,40,17,12,9,1,0
15:00,Sheffield Weds,Cambridge,6,0,H,4,0,H,S Stockbridge,23,6,10,2,9,5,6,2,0,0,0,0,0,0,4,6,29,12,8,14,0,0
15:00,Shrewsbury,Oxford,1,2,A,0,1,A,A Davies,14,8,5,3,12,3,8,0,1,0,0,0,10,0,1,3,22,8,8,15,1,0
15:00,Sunderland,Crewe,2,0,H,0,0,D,N Hair,14,3,7,1,13,11,7,2,5,3,0,0,50,30,0,2,17,8,9,24,8,0
15:00,Wycombe,Rotherham,0,0,D,0,0,D,C Hicks,12,12,1,4,10,12,2,2,1,2,0,0,10,20,0,0,24,5,4,22,3,0
19:45,Charlton,Gillingham,1,0,H,1,0,H,W Finnie,16,7,4,2,10,10,4,4,2,1,0,0,20,10,1,1,23,6,8,20,3,0
19:45,Crewe,Wigan,0,2,A,0,1,A,B Toner,7,13,2,4,14,14,2,5,1,2,0,0,10,20,1,2,20,6,7,28,3,0
19:45,Plymouth,Portsmouth,1,0,H,0,0,D,S Purkiss,20,13,6,0,10,9,4,10,2,2,0,0,20,20,0,1,33,6,14,19,4,0
19:45,Rotherham,Lincoln,2,1,H,2,0,H,A Haines,13,10,7,3,15,12,6,3,2,2,0,0,20,20,2,3,23,10,9,27,4,0
19:45,Sheffield Weds,Accrington,1,1,D,0,0,D,R Joyce,12,7,5,2,13,6,7,1,1,0,0,0,10,0,0,2,19,7,8,19,1,0
19:45,Shrewsbury,Morecambe,5,0,H,1,0,H,D Drysdale,14,8,6,0,9,7,0,2,0,2,0,0,0,20,1,5,22,6,2,16,2,0
19:45,Wycombe,Fleetwood Town,1,0,H,0,0,D,J Smith,19,9,3,4,20,12,3,3,2,2,0,0,20,20,0,1,28,7,6,32,4,0
15:00,Cambridge,Milton Keynes Dons,0,1,A,0,0,D,S Barrott,11,8,2,4,14,12,1,8,1,3,0,0,10,30,0,1,19,6,9,26,4,0
15:00,Charlton,Burton,2,0,H,2,0,H,R Welch,7,13,3,0,12,13,1,5,0,6,0,0,0,60,2,2,20,3,6,25,6,0
15:00,Cheltenham,AFC Wimbledon,3,1,H,0,1,A,S Oldham,14,11,4,4,7,10,5,2,2,1,0,0,20,10,1,4,25,8,7,17,3,0
15:00,Crewe,Bolton,0,1,A,0,0,D,S Purkiss,2,16,1,5,13,16,7,7,1,1,0,0,10,10,0,1,18,6,14,29,2,0
15:00,Fleetwood Town,Doncaster,0,0,D,0,0,D,P Howard,10,8,3,4,10,15,6,5,0,1,0,0,0,10,0,0,18,7,11,25,1,0
15:00,Gillingham,Sheffield Weds,0,0,D,0,0,D,G Ward,10,12,6,2,9,12,4,4,3,3,0,0,30,30,0,0,22,8,8,21,6,0
15:00,Lincoln,Sunderland,0,0,D,0,0,D,C Hicks,8,16,2,4,15,15,7,9,2,1,0,0,20,10,0,0,24,6,16,30,3,0
15:00,Oxford,Ipswich,1,1,D,0,0,D,M Edwards,16,12,4,6,8,10,5,4,2,2,0,0,20,20,0,2,28,10,9,18,4,0
15:00,Plymouth,Accrington,4,0,H,2,0,H,C Breakspear,16,16,7,4,7,12,6,9,1,1,0,1,10,35,2,4,32,11,15,19,2,1
15:00,Portsmouth,Wycombe,0,0,D,0,0,D,B Speedie,6,15,1,4,13,21,2,8,3,1,0,0,30,10,0,0,21,5,10,34,4,0
15:00,Rotherham,Shrewsbury,0,3,A,0,1,A,A Backhouse,12,18,2,10,5,11,6,7,1,3,1,0,35,30,1,3,30,12,13,16,4,1
15:00,Wigan,Morecambe,4,1,H,2,0,H,J Oldham,20,5,10,2,6,10,6,3,0,1,0,0,0,10,2,5,25,12,9,16,1,0
19:45,Plymouth,Cheltenham,2,0,H,2,0,H,C Pollard,17,16,6,9,9,3,5,3,0,1,0,0,0,10,2,2,33,15,8,12,1,0
15:00,Accrington,Gillingham,1,2,A,0,0,D,S Oldham,20,10,8,4,10,15,5,4,2,1,0,0,20,10,0,3,30,12,9,25,3,0
15:00,AFC Wimbledon,Cambridge,0,1,A,0,0,D,D Handley,6,5,1,2,16,13,4,2,2,2,0,0,20,20,0,1,11,3,6,29,4,0
15:00,Doncaster,Charlton,0,1,A,0,0,D,S Allison,8,14,1,9,6,11,3,2,1,4,0,0,10,40,0,1,22,10,5,17,5,0
15:00,Ipswich,Plymouth,1,0,H,1,0,H,D Rock,18,3,4,0,13,9,4,4,2,1,0,0,20,10,1,1,21,4,8,22,3,0
15:00,Sheffield Weds,Cheltenham,4,1,H,1,1,D,L Doughty,15,8,6,3,14,11,8,2,1,3,0,0,10,30,2,5,23,9,10,25,4,0
15:00,Shrewsbury,Lincoln,1,0,H,0,0,D,C Pollard,12,6,3,0,19,8,8,5,3,0,0,0,30,0,0,1,18,3,13,27,3,0
12:30,Wigan,Bolton,1,1,D,1,0,H,S Barrott,10,5,1,2,11,9,4,3,1,1,0,0,10,10,1,2,15,3,7,20,2,0
15:00,Accrington,Cheltenham,4,4,D,2,1,H,R Lewis,21,7,8,6,13,10,6,2,1,1,1,0,35,10,3,8,28,14,8,23,2,1
15:00,Charlton,Lincoln,1,2,A,0,1,A,R Madley,17,10,3,4,12,7,9,4,0,1,1,1,25,35,1,3,27,7,13,19,1,2
15:00,Crewe,Fleetwood Town,1,3,A,1,1,D,W Finnie,17,13,7,7,7,10,10,1,0,0,0,0,0,0,2,4,30,14,11,17,0,0
15:00,Ipswich,Cambridge,0,1,A,0,0,D,C Hicks,12,8,6,3,11,4,6,5,4,3,0,0,40,30,0,1,20,9,11,15,7,0
15:00,Milton Keynes Dons,Shrewsbury,2,0,H,1,0,H,M Coy,10,7,6,2,3,12,4,2,0,5,0,0,0,50,1,2,17,8,6,15,5,0
15:00,Morecambe,Burton,3,0,H,2,0,H,R Joyce,22,8,8,2,6,10,11,7,1,1,0,1,10,35,2,3,30,10,18,16,2,1
15:00,Plymouth,Oxford,1,0,H,0,0,D,O Yates,11,8,1,2,11,14,1,3,1,3,0,0,10,30,0,1,19,3,4,25,4,0
15:00,Sheffield Weds,AFC Wimbledon,2,1,H,1,1,D,P Wright,16,7,5,3,8,7,9,4,2,1,0,0,20,10,2,3,23,8,13,15,3,0
15:00,Sunderland,Gillingham,1,0,H,0,0,D,O Langford,25,5,5,0,12,13,8,1,2,4,0,0,20,40,0,1,30,5,9,25,6,0
15:00,Wycombe,Doncaster,2,0,H,1,0,H,J Busby,19,17,9,5,12,9,11,4,1,1,0,0,10,10,1,2,36,14,15,21,2,0
19:45,AFC Wimbledon,Charlton,1,1,D,0,0,D,N Hair,14,8,4,3,14,13,10,3,1,2,0,1,10,45,0,2,22,7,13,27,3,1
19:45,Cambridge,Wycombe,1,4,A,0,1,A,W Finnie,9,18,2,6,8,11,3,6,1,0,0,0,10,0,1,5,27,8,9,19,1,0
19:45,Fleetwood Town,Lincoln,1,1,D,1,0,H,P Wright,17,12,4,4,15,11,4,5,2,3,0,0,20,30,1,2,29,8,9,26,5,0
19:45,Milton Keynes Dons,Crewe,2,1,H,2,0,H,R Joyce,9,4,4,1,12,14,5,3,0,1,0,0,0,10,2,3,13,5,8,26,1,0
19:45,Morecambe,Oxford,2,1,H,2,1,H,R Lewis,6,20,3,7,12,8,1,9,2,1,0,0,20,10,3,3,26,10,10,20,3,0
19:45,Wigan,Accrington,3,0,H,2,0,H,A Backhouse,14,14,7,3,14,15,5,2,1,2,0,0,10,20,2,3,28,10,7,29,3,0
20:00,Bolton,Portsmouth,1,1,D,0,0,D,M Edwards,12,12,6,5,10,11,1,3,2,0,0,0,20,0,0,2,24,11,4,21,2,0
15:00,AFC Wimbledon,Milton Keynes Dons,1,1,D,1,0,H,J Oldham,8,14,3,6,17,11,1,6,3,2,0,0,30,20,1,2,22,9,7,28,5,0
15:00,Bolton,Sheffield Weds,1,1,D,0,0,D,C Brook,8,21,2,5,12,15,4,10,4,2,0,0,40,20,0,2,29,7,14,27,6,0
15:00,Burton,Plymouth,0,0,D,0,0,D,L Doughty,6,9,3,2,17,11,1,3,2,1,0,0,20,10,0,0,15,5,4,28,3,0
15:00,Cambridge,Morecambe,2,1,H,1,0,H,C Boyeson,15,19,5,5,12,12,3,5,0,1,0,0,0,10,1,3,34,10,8,24,1,0
15:00,Cheltenham,Portsmouth,1,0,H,0,0,D,O Yates,19,17,7,5,8,9,7,9,1,0,0,0,10,0,0,1,36,12,16,17,1,0
15:00,Doncaster,Crewe,2,0,H,1,0,H,D Bourne,19,12,9,2,15,12,7,2,1,2,0,0,10,20,1,2,31,11,9,27,3,0
15:00,Fleetwood Town,Accrington,1,2,A,1,0,H,J Simpson,11,24,3,7,21,14,5,9,1,3,1,0,35,30,1,3,35,10,14,35,4,1
15:00,Gillingham,Wycombe,1,1,D,0,1,A,S Mather,18,13,5,6,12,10,6,3,2,1,0,1,20,35,1,2,31,11,9,22,3,1
15:00,Lincoln,Wigan,1,3,A,1,2,A,S Oldham,13,14,4,6,8,14,5,8,1,4,0,0,10,40,3,4,27,10,13,22,5,0
15:00,Oxford,Sunderland,1,2,A,1,1,D,B Toner,20,11,6,5,9,14,5,4,0,2,0,0,0,20,2,3,31,11,9,23,2,0
15:00,Rotherham,Charlton,0,1,A,0,0,D,R Joyce,10,9,1,5,9,12,9,3,0,1,0,0,0,10,0,1,19,6,12,21,1,0
15:00,Shrewsbury,Ipswich,1,1,D,0,1,A,D Handley,5,8,1,4,13,12,3,3,4,3,0,1,40,55,1,2,13,5,6,25,7,1
19:45,Burton,Wigan,0,0,D,0,0,D,A Haines,9,10,3,2,16,11,5,4,3,3,0,0,30,30,0,0,19,5,9,27,6,0
19:45,Portsmouth,Rotherham,3,0,H,1,0,H,D Rock,10,9,6,1,17,17,5,4,2,3,0,0,20,30,1,3,19,7,9,34,5,0
15:00,Accrington,Burton,0,0,D,0,0,D,O Yates,17,6,5,2,10,11,5,7,1,2,0,0,10,20,0,0,23,7,12,21,3,0
15:00,Charlton,Morecambe,2,3,A,0,2,A,M Edwards,23,11,4,4,6,5,6,6,1,0,0,0,10,0,2,5,34,8,12,11,1,0
15:00,Cheltenham,Gillingham,2,2,D,1,1,D,D Rock,18,12,10,6,15,15,5,5,2,1,0,0,20,10,2,4,30,16,10,30,3,0
15:00,Crewe,AFC Wimbledon,3,1,H,0,1,A,D Webb,21,12,5,5,4,12,6,5,0,0,0,0,0,0,1,4,33,10,11,16,0,0
15:00,Doncaster,Bolton,1,2,A,0,0,D,J Oldham,19,11,6,2,12,14,8,3,2,4,0,0,20,40,0,3,30,8,11,26,6,0
15:00,Fleetwood Town,Oxford,2,3,A,1,3,A,R Madley,19,11,6,5,9,10,5,0,1,2,0,0,10,20,4,5,30,11,5,19,3,0
15:00,Portsmouth,Lincoln,3,2,H,0,0,D,T Kettle,17,26,7,6,12,8,5,7,1,1,0,0,10,10,0,5,43,13,12,20,2,0
15:00,Sunderland,Shrewsbury,3,2,H,2,0,H,D Bond,18,9,7,3,6,11,4,2,2,3,0,0,20,30,2,5,27,10,6,17,5,0
15:00,Wycombe,Plymouth,2,0,H,2,0,H,D Drysdale,13,9,5,2,12,7,5,2,2,0,0,0,20,0,2,2,22,7,7,19,2,0
12:30,Rotherham,Ipswich,1,0,H,0,0,D,P Wright,14,3,3,1,4,16,10,6,1,5,0,0,10,50,0,1,17,4,16,20,6,0
17:15,Wigan,Cambridge,1,2,A,0,2,A,R Joyce,11,9,2,5,10,7,8,4,2,3,0,0,20,30,2,3,20,7,12,17,5,0
19:45,Milton Keynes Dons,Sheffield Weds,2,3,A,1,3,A,B Toner,10,6,4,4,9,16,3,2,2,3,0,0,20,30,4,5,16,8,5,25,5,0
15:00,AFC Wimbledon,Wycombe,1,1,D,1,0,H,S Barrott,9,17,2,5,16,12,2,7,2,2,0,0,20,20,1,2,26,7,9,28,4,0
15:00,Bolton,Accrington,3,1,H,1,0,H,T Bramall,17,15,3,6,11,13,3,1,4,4,0,1,40,65,1,4,32,9,4,24,8,1
15:00,Gillingham,Fleetwood Town,0,0,D,0,0,D,J Linington,16,7,6,3,8,7,1,3,3,0,1,1,55,25,0,0,23,9,4,15,3,2
15:00,Lincoln,Cheltenham,3,0,H,3,0,H,S Mather,15,11,8,4,7,22,6,2,0,3,0,0,0,30,3,3,26,12,8,29,3,0
15:00,Morecambe,Portsmouth,1,1,D,0,1,A,R Madley,19,9,5,3,12,5,10,5,1,0,0,0,10,0,1,2,28,8,15,17,1,0
15:00,Plymouth,Sunderland,0,0,D,0,0,D,C Brook,7,10,1,2,11,12,7,3,1,2,0,0,10,20,0,0,17,3,10,23,3,0
15:00,Shrewsbury,Doncaster,3,3,D,3,0,H,A Kitchen,19,17,8,8,10,6,8,4,1,0,0,0,10,0,3,6,36,16,12,16,1,0
19:45,Burton,Rotherham,2,0,H,1,0,H,T Reeves,13,21,7,5,14,8,6,13,2,2,0,0,20,20,1,2,34,12,19,22,4,0
19:45,Cambridge,Charlton,0,2,A,0,0,D,P Howard,10,14,1,9,9,13,8,7,0,2,0,0,0,20,0,2,24,10,15,22,2,0
19:45,Ipswich,Wigan,2,2,D,0,1,A,W Finnie,10,7,4,5,12,9,5,2,4,2,0,0,40,20,1,4,17,9,7,21,6,0
19:45,Oxford,Milton Keynes Dons,1,0,H,0,0,D,A Backhouse,8,10,2,2,10,6,8,3,3,0,0,0,30,0,0,1,18,4,11,16,3,0
19:45,Sheffield Weds,Crewe,1,0,H,0,0,D,C Breakspear,18,1,5,1,12,10,7,4,1,2,0,0,10,20,0,1,19,6,11,22,3,0
15:00,Accrington,Lincoln,2,1,H,1,0,H,M Edwards,18,8,5,4,14,10,2,1,0,3,1,0,25,30,1,3,26,9,3,24,3,1
15:00,Charlton,Shrewsbury,2,0,H,0,0,D,S Purkiss,16,12,8,6,11,14,7,3,0,0,0,0,0,0,0,2,28,14,10,25,0,0
15:00,Cheltenham,Bolton,1,2,A,0,0,D,N Hair,8,13,4,4,12,8,4,7,2,0,0,0,20,0,0,3,21,8,11,20,2,0
15:00,Crewe,Ipswich,1,1,D,0,1,A,S Mather,11,18,4,7,9,11,4,6,2,2,0,0,20,20,1,2,29,11,10,20,4,0
15:00,Doncaster,Burton,2,0,H,1,0,H,W Finnie,6,14,3,2,8,15,1,12,0,3,0,0,0,30,1,2,20,5,13,23,3,0
15:00,Fleetwood Town,AFC Wimbledon,1,1,D,0,1,A,A Backhouse,10,5,3,1,15,15,4,1,2,5,0,0,20,50,1,2,15,4,5,30,7,0
15:00,Milton Keynes Dons,Morecambe,2,0,H,1,0,H,L Swabey,12,4,7,0,8,17,5,3,2,4,0,0,20,40,1,2,16,7,8,25,6,0
15:00,Portsmouth,Gillingham,3,1,H,2,1,H,D Drysdale,16,9,9,2,10,9,5,2,0,2,0,0,0,20,3,4,25,11,7,19,2,0
15:00,Rotherham,Oxford,2,1,H,1,1,D,C Breakspear,16,6,6,2,12,14,6,3,3,2,0,0,30,20,2,3,22,8,9,26,5,0
15:00,Sunderland,Cambridge,5,1,H,3,1,H,P Wright,28,4,11,1,10,10,4,2,0,2,0,1,0,45,4,6,32,12,6,20,2,1
15:00,Wigan,Plymouth,1,1,D,0,0,D,S Stockbridge,11,5,4,2,12,8,15,3,3,1,0,0,30,10,0,2,16,6,18,20,4,0
15:00,Wycombe,Sheffield Weds,1,0,H,0,0,D,A Davies,6,15,3,3,13,8,2,12,2,2,0,0,20,20,0,1,21,6,14,21,4,0
19:45,Fleetwood Town,Sheffield Weds,2,3,A,2,1,H,C Boyeson,5,22,2,6,12,10,1,8,3,2,0,0,30,20,3,5,27,8,9,22,5,0
19:45,Portsmouth,Wigan,3,2,H,0,2,A,C Hicks,15,12,5,5,13,16,5,7,1,2,0,0,10,20,2,5,27,10,12,29,3,0
19:45,Sunderland,Rotherham,1,1,D,0,1,A,R Madley,5,13,0,2,7,16,4,10,1,1,0,0,10,10,1,2,18,2,14,23,2,0
12:30,AFC Wimbledon,Accrington,3,4,A,0,3,A,D Rock,11,18,5,7,9,18,4,6,0,2,0,0,0,20,3,7,29,12,10,27,2,0
12:30,Bolton,Fleetwood Town,4,2,H,1,1,D,M Coy,14,10,6,5,4,8,5,5,0,2,0,0,0,20,2,6,24,11,10,12,2,0
12:30,Burton,Wycombe,1,2,A,0,1,A,R Madley,13,12,3,6,9,10,3,12,2,2,0,0,20,20,1,3,25,9,15,19,4,0
12:30,Cambridge,Cheltenham,2,2,D,1,1,D,T Reeves,18,15,7,3,9,13,10,6,2,3,0,1,20,55,2,4,33,10,16,22,5,1
12:30,Gillingham,Rotherham,0,2,A,0,1,A,S Barrott,7,17,2,7,10,11,4,10,3,3,0,0,30,30,1,2,24,9,14,21,6,0
12:30,Ipswich,Charlton,4,0,H,2,0,H,C Breakspear,21,10,4,2,14,8,6,5,0,1,0,0,0,10,2,4,31,6,11,22,1,0
12:30,Lincoln,Crewe,2,1,H,0,1,A,A Kitchen,15,12,11,5,10,5,4,8,0,0,0,0,0,0,1,3,27,16,12,15,0,0
12:30,Morecambe,Sunderland,0,1,A,0,1,A,G Ward,5,7,0,3,15,13,4,3,4,1,0,0,40,10,1,1,12,3,7,28,5,0
12:30,Oxford,Doncaster,1,1,D,1,0,H,T Kettle,14,6,6,2,12,15,5,7,0,1,0,0,0,10,1,2,20,8,12,27,1,0
12:30,Plymouth,Milton Keynes Dons,0,5,A,0,3,A,C Hicks,10,22,4,11,16,9,1,8,1,0,1,0,35,0,3,5,32,15,9,25,1,1
12:30,Sheffield Weds,Portsmouth,4,1,H,3,1,H,A Backhouse,13,11,8,3,8,14,7,4,3,1,0,0,30,10,4,5,24,11,11,22,4,0
12:30,Shrewsbury,Wigan,0,3,A,0,1,A,S Martin,7,11,4,4,19,11,0,6,2,0,0,0,20,0,1,3,18,8,6,30,2,0
